s1,s2,s3,s4,s5,marks obtained,marks_obtained,total
80,94,81,89,82,426,426,500
95,80,93,99,85,452,452,500
98,91,83,91,99,462,462,500
86,95,85,84,93,443,443,500
80,84,90,96,99,449,449,500
95,93,98,82,92,460,460,500
85,97,80,94,81,437,437,500
92,82,81,86,94,435,435,500
80,89,92,83,99,443,443,500
99,96,95,95,92,477,477,500
92,82,94,98,88,454,454,500
94,92,98,98,81,463,463,500
93,89,95,98,88,463,463,500
85,93,89,81,99,447,447,500
91,99,95,87,92,464,464,500
80,83,90,98,91,442,442,500
91,84,82,97,91,445,445,500
85,91,83,84,86,429,429,500
84,82,80,83,93,422,422,500
95,92,93,87,90,457,457,500
80,91,89,86,93,439,439,500
86,91,94,91,98,460,460,500
88,81,86,81,88,424,424,500
94,86,98,90,81,449,449,500
97,83,84,84,90,438,438,500
97,89,84,95,94,459,459,500
98,86,81,97,85,447,447,500
82,84,84,88,93,431,431,500
83,95,93,96,87,454,454,500
93,89,88,90,87,447,447,500
87,81,93,89,83,433,433,500
80,97,83,92,88,440,440,500
82,90,83,91,89,435,435,500
87,97,80,90,94,448,448,500
89,86,88,90,89,442,442,500
97,89,95,92,86,459,459,500
81,82,99,96,97,455,455,500
85,94,89,97,94,459,459,500
82,91,97,90,95,455,455,500
95,98,99,88,85,465,465,500
87,93,91,82,99,452,452,500
88,85,83,92,80,428,428,500
89,95,99,93,94,470,470,500
92,96,87,81,84,440,440,500
96,80,84,92,81,433,433,500
81,85,99,92,82,439,439,500
80,89,90,92,88,439,439,500
91,92,83,84,88,438,438,500
83,87,88,99,99,456,456,500
88,92,96,95,94,465,465,500
85,80,85,95,98,443,443,500
80,83,81,94,87,425,425,500
90,84,84,89,93,440,440,500
81,92,87,93,87,440,440,500
91,96,95,93,95,470,470,500
96,89,80,90,90,445,445,500
87,96,94,83,88,448,448,500
89,99,81,87,84,440,440,500
81,84,85,87,84,421,421,500
96,92,90,82,98,458,458,500
81,87,95,90,95,448,448,500
81,88,86,86,88,429,429,500
93,98,98,92,96,477,477,500
92,85,99,94,81,451,451,500
86,83,93,82,86,430,430,500
96,90,84,99,98,467,467,500
96,98,92,84,89,459,459,500
89,80,89,99,94,451,451,500
94,92,94,85,89,454,454,500
97,84,82,86,97,446,446,500
97,94,91,93,97,472,472,500
98,81,87,92,87,445,445,500
97,85,94,98,80,454,454,500
90,98,85,90,85,448,448,500
91,94,86,97,98,466,466,500
89,82,99,81,80,431,431,500
83,89,92,97,94,455,455,500
87,92,94,93,93,459,459,500
85,91,98,81,99,454,454,500
92,92,99,87,95,465,465,500
88,88,93,88,97,454,454,500
87,81,80,88,94,430,430,500
86,87,98,82,80,433,433,500
91,87,90,98,97,463,463,500
80,80,81,88,89,418,418,500
96,82,86,88,86,438,438,500
92,84,92,89,90,447,447,500
91,98,92,94,84,459,459,500
81,82,84,88,98,433,433,500
86,96,82,99,91,454,454,500
92,80,95,89,92,448,448,500
94,83,96,89,89,451,451,500
94,80,81,91,88,434,434,500
95,92,81,92,92,452,452,500
80,92,94,90,88,444,444,500
85,96,81,87,91,440,440,500
89,87,81,80,92,429,429,500
83,98,91,85,92,449,449,500
90,94,88,87,94,453,453,500
93,85,82,97,81,438,438,500
96,96,87,98,89,466,466,500
99,98,87,97,89,470,470,500
85,80,92,81,94,432,432,500
98,99,82,99,92,470,470,500
91,80,83,89,95,438,438,500
99,98,93,80,99,469,469,500
87,83,98,94,96,458,458,500
92,94,96,89,96,467,467,500
95,87,80,82,87,431,431,500
92,98,92,93,82,457,457,500
84,87,92,97,89,449,449,500
83,84,80,99,90,436,436,500
88,81,88,85,81,423,423,500
94,90,98,86,91,459,459,500
85,90,93,88,82,438,438,500
96,83,83,84,80,426,426,500
88,94,95,98,88,463,463,500
94,98,94,99,95,480,480,500
90,87,81,89,88,435,435,500
97,81,88,98,98,462,462,500
91,93,99,94,89,466,466,500
94,95,83,88,89,449,449,500
87,83,87,96,90,443,443,500
94,94,95,99,96,478,478,500
92,91,91,84,95,453,453,500
88,91,91,95,86,451,451,500
80,87,88,87,92,434,434,500
93,85,94,83,91,446,446,500
81,84,91,90,96,442,442,500
93,94,96,95,80,458,458,500
92,85,81,86,88,432,432,500
94,88,98,84,99,463,463,500
91,94,82,96,88,451,451,500
98,97,82,91,94,462,462,500
91,96,88,90,98,463,463,500
80,97,98,80,91,446,446,500
83,89,96,89,80,437,437,500
96,84,90,81,97,448,448,500
92,80,89,98,80,439,439,500
83,83,83,81,97,427,427,500
97,82,82,88,84,433,433,500
98,93,85,97,80,453,453,500
96,98,97,83,84,458,458,500
88,86,92,91,84,441,441,500
87,95,88,90,88,448,448,500
91,95,85,91,81,443,443,500
89,86,95,86,83,439,439,500
87,81,87,89,90,434,434,500
82,81,83,98,90,434,434,500
89,83,92,97,89,450,450,500
81,93,90,98,91,453,453,500
81,94,91,86,93,445,445,500
94,82,80,82,80,418,418,500
80,98,91,87,98,454,454,500
80,89,93,96,98,456,456,500
89,92,93,97,81,452,452,500
85,82,85,84,92,428,428,500
92,93,91,82,94,452,452,500
95,94,81,95,81,446,446,500
85,89,88,90,82,434,434,500
81,97,96,99,86,459,459,500
85,89,88,80,98,440,440,500
94,95,81,80,88,438,438,500
84,83,83,90,98,438,438,500
91,87,82,95,96,451,451,500
97,91,82,94,97,461,461,500
89,89,93,93,98,462,462,500
87,81,92,97,81,438,438,500
84,83,99,85,97,448,448,500
83,85,82,83,92,425,425,500
97,90,90,85,87,449,449,500
84,83,97,82,93,439,439,500
84,87,89,87,86,433,433,500
91,97,90,81,90,449,449,500
83,95,94,94,84,450,450,500
97,87,80,95,98,457,457,500
86,97,83,95,86,447,447,500
80,97,93,82,94,446,446,500
91,94,90,87,95,457,457,500
91,94,86,93,91,455,455,500
99,87,90,89,80,445,445,500
80,92,95,90,93,450,450,500
84,99,99,97,97,476,476,500
99,90,92,95,87,463,463,500
90,96,95,97,95,473,473,500
81,99,98,83,98,459,459,500
87,86,92,85,97,447,447,500
85,83,87,86,92,433,433,500
85,93,88,83,94,443,443,500
90,94,84,80,94,442,442,500
83,92,83,95,99,452,452,500
98,80,99,93,87,457,457,500
83,88,82,99,94,446,446,500
98,90,95,90,96,469,469,500
87,85,99,89,91,451,451,500
96,88,96,99,92,471,471,500
94,85,88,94,92,453,453,500
96,88,92,86,90,452,452,500
85,99,86,89,99,458,458,500
99,96,88,97,92,472,472,500
95,81,92,94,83,445,445,500
83,92,99,90,91,455,455,500
85,89,91,82,93,440,440,500
80,96,92,82,93,443,443,500
84,96,89,94,87,450,450,500
82,97,84,80,97,440,440,500
91,82,94,81,85,433,433,500
99,90,93,81,82,445,445,500
98,99,88,84,92,461,461,500
82,85,88,82,84,421,421,500
85,94,82,90,89,440,440,500
99,93,96,84,90,462,462,500
98,86,99,86,89,458,458,500
97,84,88,80,80,429,429,500
99,89,93,98,84,463,463,500
92,96,87,97,82,454,454,500
80,98,90,91,97,456,456,500
97,92,86,85,95,455,455,500
97,83,93,93,83,449,449,500
98,97,85,85,94,459,459,500
87,94,88,91,96,456,456,500
80,95,96,88,83,442,442,500
90,85,82,83,91,431,431,500
84,92,92,84,86,438,438,500
84,80,93,83,81,421,421,500
81,92,90,86,90,439,439,500
99,86,89,85,95,454,454,500
87,89,95,97,94,462,462,500
90,88,96,93,82,449,449,500
91,84,99,86,90,450,450,500
80,90,87,83,87,427,427,500
99,82,83,92,90,446,446,500
88,88,99,89,85,449,449,500
97,97,85,82,94,455,455,500
88,89,94,91,83,445,445,500
94,82,81,84,95,436,436,500
98,98,92,97,97,482,482,500
94,97,99,84,86,460,460,500
96,92,84,99,92,463,463,500
93,91,81,92,81,438,438,500
86,97,97,81,94,455,455,500
90,97,98,89,93,467,467,500
93,84,82,82,84,425,425,500
84,95,82,90,97,448,448,500
82,98,85,91,89,445,445,500
90,99,94,87,92,462,462,500
97,89,83,88,88,445,445,500
97,94,98,80,98,467,467,500
97,86,88,80,87,438,438,500
86,82,99,81,97,445,445,500
95,90,90,93,98,466,466,500
83,86,97,82,93,441,441,500
92,80,90,92,86,440,440,500
89,85,84,85,89,432,432,500
83,86,82,83,93,427,427,500
83,96,86,87,94,446,446,500
90,96,98,94,91,469,469,500
96,97,92,80,89,454,454,500
96,97,91,94,95,473,473,500
93,88,83,80,92,436,436,500
91,82,90,84,89,436,436,500
87,81,88,82,87,425,425,500
96,97,94,92,94,473,473,500
93,85,87,82,85,432,432,500
99,91,86,96,83,455,455,500
81,80,89,95,83,428,428,500
98,83,83,88,96,448,448,500
84,90,94,85,93,446,446,500
91,92,84,80,95,442,442,500
99,87,97,96,86,465,465,500
93,89,93,91,95,461,461,500
89,98,86,98,96,467,467,500
95,95,96,99,85,470,470,500
85,84,86,96,80,431,431,500
85,97,84,93,91,450,450,500
95,99,81,99,93,467,467,500
92,87,83,95,83,440,440,500
88,82,93,91,83,437,437,500
95,89,96,91,93,464,464,500
96,82,82,82,81,423,423,500
85,97,97,94,82,455,455,500
96,84,82,97,94,453,453,500
80,86,93,85,96,440,440,500
97,99,94,87,80,457,457,500
92,93,89,80,85,439,439,500
92,83,83,80,88,426,426,500
82,88,98,98,86,452,452,500
92,83,85,89,93,442,442,500
94,94,80,98,85,451,451,500
92,84,92,83,96,447,447,500
85,84,86,83,83,421,421,500
88,97,93,87,86,451,451,500
89,97,86,87,90,449,449,500
91,82,82,90,91,436,436,500
82,83,92,95,96,448,448,500
93,92,87,82,84,438,438,500
84,85,94,85,92,440,440,500
82,85,88,80,80,415,415,500
89,97,90,99,97,472,472,500
87,80,98,98,93,456,456,500
83,93,95,96,87,454,454,500
86,84,87,86,80,423,423,500
83,98,96,82,90,449,449,500
99,97,81,89,83,449,449,500
91,81,91,81,87,431,431,500
81,98,88,92,90,449,449,500
94,86,87,80,88,435,435,500
88,95,82,80,94,439,439,500
84,95,91,82,94,446,446,500
86,88,94,80,96,444,444,500
84,92,97,81,90,444,444,500
94,84,87,93,99,457,457,500
80,82,94,91,93,440,440,500
81,96,85,99,93,454,454,500
80,93,82,91,82,428,428,500
87,98,83,96,84,448,448,500
88,88,92,87,96,451,451,500
92,94,83,83,96,448,448,500
95,96,99,95,82,467,467,500
82,95,91,87,82,437,437,500
88,85,96,91,85,445,445,500
90,97,97,84,99,467,467,500
87,86,98,80,93,444,444,500
89,92,82,89,96,448,448,500
92,91,86,82,86,437,437,500
96,88,83,99,84,450,450,500
87,82,98,95,84,446,446,500
87,81,92,89,82,431,431,500
80,98,87,82,89,436,436,500
83,94,89,87,82,435,435,500
89,90,99,89,89,456,456,500
98,98,88,80,92,456,456,500
87,91,83,87,86,434,434,500
96,83,90,98,84,451,451,500
87,95,84,83,85,434,434,500
85,95,98,94,86,458,458,500
85,91,92,95,93,456,456,500
96,95,80,83,87,441,441,500
90,86,98,94,84,452,452,500
80,80,99,97,87,443,443,500
80,83,87,99,81,430,430,500
99,97,97,93,86,472,472,500
83,95,94,96,87,455,455,500
98,85,84,89,86,442,442,500
95,88,94,82,97,456,456,500
83,94,94,91,90,452,452,500
88,80,87,87,85,427,427,500
93,83,84,82,82,424,424,500
81,87,95,94,88,445,445,500
93,98,85,98,94,468,468,500
99,80,96,98,83,456,456,500
98,83,80,90,84,435,435,500
93,94,96,82,92,457,457,500
90,86,99,92,86,453,453,500
92,93,93,98,97,473,473,500
97,97,99,96,95,484,484,500
82,93,93,87,97,452,452,500
95,80,88,92,96,451,451,500
81,94,88,96,86,445,445,500
84,83,81,96,81,425,425,500
93,83,86,82,90,434,434,500
86,91,86,81,98,442,442,500
95,87,99,89,84,454,454,500
87,97,84,99,88,455,455,500
83,86,98,92,92,451,451,500
86,80,99,94,85,444,444,500
96,84,98,91,81,450,450,500
80,88,90,95,84,437,437,500
89,83,98,89,90,449,449,500
84,96,88,97,80,445,445,500
84,93,92,93,92,454,454,500
87,99,99,87,91,463,463,500
97,99,85,81,93,455,455,500
85,88,87,80,82,422,422,500
90,86,92,93,87,448,448,500
87,89,92,98,83,449,449,500
83,92,93,97,90,455,455,500
80,86,96,93,94,449,449,500
87,95,83,87,85,437,437,500
81,96,88,88,84,437,437,500
99,93,83,88,94,457,457,500
98,98,99,88,99,482,482,500
96,87,84,94,99,460,460,500
98,88,90,91,80,447,447,500
88,88,94,97,90,457,457,500
82,91,92,86,82,433,433,500
94,88,87,81,84,434,434,500
97,93,88,87,90,455,455,500
99,91,83,93,80,446,446,500
84,83,89,92,94,442,442,500
88,91,97,88,81,445,445,500
97,94,84,98,96,469,469,500
91,85,81,82,91,430,430,500
95,83,82,91,93,444,444,500
92,83,89,98,95,457,457,500
88,81,98,80,84,431,431,500
89,87,87,97,98,458,458,500
82,91,99,93,82,447,447,500
82,84,84,82,84,416,416,500
90,98,99,99,82,468,468,500
90,82,84,98,93,447,447,500
94,98,84,98,80,454,454,500
92,81,82,88,99,442,442,500
85,88,92,90,91,446,446,500
96,87,89,97,93,462,462,500
90,82,87,87,99,445,445,500
99,92,87,98,98,474,474,500
82,83,99,93,82,439,439,500
82,96,80,85,94,437,437,500
99,95,82,82,96,454,454,500
98,89,90,99,89,465,465,500
99,97,85,96,93,470,470,500
89,87,83,81,81,421,421,500
84,83,80,92,98,437,437,500
90,96,80,88,98,452,452,500
90,95,96,98,94,473,473,500
90,85,97,86,92,450,450,500
82,92,81,82,83,420,420,500
94,90,80,89,82,435,435,500
98,94,96,82,84,454,454,500
82,94,96,93,85,450,450,500
93,83,95,86,80,437,437,500
89,90,96,95,93,463,463,500
99,83,86,92,94,454,454,500
92,96,85,99,96,468,468,500
81,81,89,95,84,430,430,500
98,94,88,91,88,459,459,500
84,89,81,90,96,440,440,500
99,90,81,83,85,438,438,500
90,97,99,83,94,463,463,500
97,81,90,85,97,450,450,500
88,99,89,99,99,474,474,500
86,82,82,81,98,429,429,500
81,82,98,98,98,457,457,500
89,92,97,81,93,452,452,500
92,97,87,84,84,444,444,500
95,95,99,93,88,470,470,500
85,80,86,87,81,419,419,500
83,88,86,86,98,441,441,500
87,95,81,96,90,449,449,500
92,99,89,90,91,461,461,500
97,94,97,93,89,470,470,500
89,83,88,99,90,449,449,500
93,97,87,81,94,452,452,500
99,84,95,86,91,455,455,500
81,87,97,89,96,450,450,500
89,92,89,90,92,452,452,500
83,88,95,86,83,435,435,500
88,96,89,96,87,456,456,500
92,88,80,80,80,420,420,500
84,92,82,99,89,446,446,500
81,96,80,98,93,448,448,500
95,91,96,90,89,461,461,500
99,85,91,86,92,453,453,500
88,91,99,89,80,447,447,500
97,80,95,95,88,455,455,500
82,99,96,89,97,463,463,500
87,87,91,83,99,447,447,500
87,80,98,96,93,454,454,500
85,84,96,89,90,444,444,500
96,81,95,95,83,450,450,500
87,86,91,94,88,446,446,500
98,98,90,98,99,483,483,500
84,80,99,95,82,440,440,500
90,98,80,89,95,452,452,500
99,89,99,93,81,461,461,500
93,89,92,83,84,441,441,500
87,87,91,94,86,445,445,500
91,89,89,93,85,447,447,500
98,91,94,89,94,466,466,500
95,87,86,82,87,437,437,500
96,81,81,97,82,437,437,500
95,81,89,94,99,458,458,500
90,82,96,94,88,450,450,500
82,97,97,98,80,454,454,500
99,83,96,93,83,454,454,500
84,90,91,85,87,437,437,500
99,85,83,94,87,448,448,500
99,96,82,92,91,460,460,500
96,95,93,82,87,453,453,500
92,86,84,81,81,424,424,500
90,94,85,86,92,447,447,500
91,84,97,90,80,442,442,500
93,95,92,94,92,466,466,500
85,95,95,80,98,453,453,500
82,87,95,92,89,445,445,500
95,98,80,89,87,449,449,500
88,88,81,80,86,423,423,500
84,80,86,94,85,429,429,500
80,81,94,81,99,435,435,500
89,84,92,81,94,440,440,500
92,81,96,88,92,449,449,500
96,81,96,90,88,451,451,500
87,98,81,97,90,453,453,500
84,99,96,90,81,450,450,500
88,89,80,80,86,423,423,500
82,94,87,99,94,456,456,500
85,88,89,86,96,444,444,500
83,91,97,85,87,443,443,500
91,95,91,84,81,442,442,500
95,89,97,97,91,469,469,500
86,91,80,85,83,425,425,500
93,97,95,96,95,476,476,500
92,81,80,88,94,435,435,500
94,97,93,94,88,466,466,500
90,90,83,82,81,426,426,500
99,92,95,88,87,461,461,500
97,96,95,96,86,470,470,500
82,91,82,96,89,440,440,500
92,91,89,88,80,440,440,500
82,94,94,85,99,454,454,500
92,83,82,84,83,424,424,500
97,97,84,87,89,454,454,500
80,89,83,84,88,424,424,500
94,87,80,98,80,439,439,500
88,86,87,89,92,442,442,500
88,87,91,84,88,438,438,500
97,89,96,84,98,464,464,500
95,96,95,95,98,479,479,500
87,82,89,97,90,445,445,500
82,87,83,89,91,432,432,500
97,80,82,94,97,450,450,500
81,81,97,84,87,430,430,500
80,97,90,94,99,460,460,500
99,95,82,91,83,450,450,500
80,86,81,88,80,415,415,500
90,84,92,91,84,441,441,500
98,83,86,83,81,431,431,500
93,92,96,93,84,458,458,500
98,90,94,91,92,465,465,500
97,97,93,85,83,455,455,500
97,99,94,84,83,457,457,500
83,81,87,86,82,419,419,500
89,80,87,96,88,440,440,500
83,81,84,89,89,426,426,500
96,81,80,97,82,436,436,500
80,83,97,85,98,443,443,500
81,89,95,88,85,438,438,500
87,92,80,99,87,445,445,500
82,89,83,90,83,427,427,500
96,91,92,82,92,453,453,500
85,88,89,91,96,449,449,500
81,94,94,92,94,455,455,500
88,84,86,93,96,447,447,500
96,99,89,86,83,453,453,500
86,80,85,82,82,415,415,500
88,81,90,84,85,428,428,500
82,85,96,88,86,437,437,500
84,98,81,85,80,428,428,500
85,89,94,91,89,448,448,500
98,93,99,82,95,467,467,500
89,89,92,88,93,451,451,500
88,90,97,83,97,455,455,500
87,98,94,80,84,443,443,500
90,80,96,92,85,443,443,500
83,81,81,81,91,417,417,500
91,84,87,95,94,451,451,500
90,90,92,82,85,439,439,500
99,80,96,88,97,460,460,500
81,90,92,99,95,457,457,500
90,92,85,83,92,442,442,500
96,80,96,88,91,451,451,500
86,81,95,90,85,437,437,500
86,94,99,81,95,455,455,500
86,83,93,93,87,442,442,500
94,90,92,81,99,456,456,500
93,95,80,83,99,450,450,500
87,87,83,86,94,437,437,500
82,95,94,86,83,440,440,500
91,96,98,88,91,464,464,500
96,80,81,83,94,434,434,500
96,85,86,86,99,452,452,500
99,93,82,95,85,454,454,500
94,82,85,99,84,444,444,500
93,91,87,96,80,447,447,500
83,93,82,82,84,424,424,500
93,85,93,97,90,458,458,500
98,83,90,91,80,442,442,500
98,98,98,97,83,474,474,500
80,83,87,90,83,423,423,500
98,91,98,98,85,470,470,500
83,90,81,89,80,423,423,500
86,92,82,80,87,427,427,500
97,92,83,95,80,447,447,500
94,85,91,86,93,449,449,500
94,80,80,93,97,444,444,500
95,98,81,86,87,447,447,500
96,88,91,85,95,455,455,500
89,81,90,80,88,428,428,500
86,93,88,90,91,448,448,500
93,91,92,93,81,450,450,500
96,84,89,87,88,444,444,500
94,97,90,81,96,458,458,500
82,83,86,92,98,441,441,500
95,81,92,90,99,457,457,500
98,96,93,85,81,453,453,500
85,82,91,93,86,437,437,500
92,81,93,80,88,434,434,500
85,87,82,97,93,444,444,500
85,98,83,99,94,459,459,500
87,89,82,81,98,437,437,500
99,95,91,88,92,465,465,500
90,82,81,82,90,425,425,500
84,98,89,89,90,450,450,500
90,92,93,98,82,455,455,500
91,95,99,88,83,456,456,500
84,87,87,88,97,443,443,500
96,97,93,80,83,449,449,500
97,96,90,98,96,477,477,500
95,92,87,84,85,443,443,500
83,85,97,92,86,443,443,500
88,90,95,80,82,435,435,500
93,97,81,93,82,446,446,500
90,90,94,88,91,453,453,500
93,96,97,81,83,450,450,500
84,80,96,94,90,444,444,500
80,98,83,88,86,435,435,500
92,87,96,97,98,470,470,500
83,91,89,85,88,436,436,500
92,96,89,87,90,454,454,500
83,85,90,99,89,446,446,500
96,90,96,83,90,455,455,500
81,93,95,81,83,433,433,500
96,98,94,97,88,473,473,500
93,86,95,93,80,447,447,500
91,94,98,89,98,470,470,500
96,90,86,80,88,440,440,500
89,81,84,82,97,433,433,500
80,90,81,87,80,418,418,500
94,96,81,81,86,438,438,500
86,99,94,95,82,456,456,500
95,84,90,94,91,454,454,500
95,99,96,84,94,468,468,500
91,86,94,92,98,461,461,500
84,90,91,81,91,437,437,500
86,96,95,81,94,452,452,500
81,93,92,83,99,448,448,500
95,91,89,83,82,440,440,500
80,93,95,93,85,446,446,500
80,90,97,89,95,451,451,500
82,97,91,92,85,447,447,500
91,88,94,99,97,469,469,500
98,81,83,93,97,452,452,500
87,84,95,90,83,439,439,500
91,91,96,88,95,461,461,500
97,92,80,91,85,445,445,500
80,90,89,80,87,426,426,500
89,93,85,85,80,432,432,500
82,94,99,85,95,455,455,500
84,81,87,93,98,443,443,500
89,97,87,87,96,456,456,500
87,81,85,89,80,422,422,500
96,90,91,97,82,456,456,500
89,84,90,88,97,448,448,500
93,94,90,90,96,463,463,500
82,87,94,85,96,444,444,500
87,85,99,83,83,437,437,500
88,93,92,82,93,448,448,500
90,87,80,92,81,430,430,500
97,84,87,81,85,434,434,500
90,80,81,88,89,428,428,500
87,83,96,82,96,444,444,500
82,96,98,89,87,452,452,500
87,81,99,89,98,454,454,500
83,95,94,95,92,459,459,500
89,85,87,90,94,445,445,500
95,83,99,91,87,455,455,500
99,86,85,85,88,443,443,500
92,88,90,98,82,450,450,500
82,99,99,81,92,453,453,500
93,85,99,84,85,446,446,500
88,82,84,95,86,435,435,500
82,96,84,97,81,440,440,500
91,86,86,91,93,447,447,500
81,90,98,91,84,444,444,500
84,95,86,89,86,440,440,500
86,87,98,98,84,453,453,500
89,92,89,90,80,440,440,500
80,88,99,86,83,436,436,500
86,94,81,81,91,433,433,500
90,88,89,81,96,444,444,500
86,97,92,95,93,463,463,500
94,92,80,86,82,434,434,500
95,85,83,89,95,447,447,500
81,81,82,92,84,420,420,500
82,84,93,96,86,441,441,500
81,95,80,87,90,433,433,500
90,83,83,82,87,425,425,500
89,84,90,92,80,435,435,500
95,97,81,94,84,451,451,500
85,86,98,93,89,451,451,500
94,88,90,89,85,446,446,500
80,81,94,90,82,427,427,500
90,93,83,94,82,442,442,500
81,81,98,98,80,438,438,500
88,89,89,81,85,432,432,500
84,95,82,80,89,430,430,500
97,92,95,93,80,457,457,500
83,92,90,81,99,445,445,500
89,81,93,85,97,445,445,500
80,89,93,90,82,434,434,500
81,89,85,98,88,441,441,500
86,95,87,97,97,462,462,500
92,88,90,83,96,449,449,500
94,86,96,98,98,472,472,500
98,91,83,96,98,466,466,500
88,82,90,99,82,441,441,500
87,92,94,80,88,441,441,500
82,89,85,97,87,440,440,500
90,99,80,82,95,446,446,500
90,89,87,86,83,435,435,500
84,94,85,83,81,427,427,500
90,87,91,82,91,441,441,500
81,80,88,88,92,429,429,500
94,99,95,81,85,454,454,500
80,81,81,82,96,420,420,500
96,81,93,92,91,453,453,500
88,95,81,86,87,437,437,500
91,87,96,86,92,452,452,500
85,80,83,82,90,420,420,500
84,82,85,95,91,437,437,500
87,84,84,97,83,435,435,500
96,80,91,87,83,437,437,500
91,85,80,98,86,440,440,500
97,89,93,95,85,459,459,500
86,84,87,96,88,441,441,500
93,81,82,95,95,446,446,500
93,80,88,96,90,447,447,500
91,84,86,89,85,435,435,500
89,90,82,96,90,447,447,500
90,88,89,92,88,447,447,500
82,98,88,80,85,433,433,500
89,97,99,89,87,461,461,500
98,95,82,83,95,453,453,500
97,83,93,81,92,446,446,500
91,87,82,98,87,445,445,500
95,96,84,97,85,457,457,500
86,93,96,91,81,447,447,500
83,97,84,99,94,457,457,500
97,88,96,96,89,466,466,500
86,80,82,91,93,432,432,500
89,81,81,88,91,430,430,500
86,94,97,89,85,451,451,500
84,95,86,93,98,456,456,500
88,96,97,82,88,451,451,500
93,89,95,84,93,454,454,500
89,88,85,83,92,437,437,500
82,80,85,90,88,425,425,500
93,89,97,81,93,453,453,500
82,94,88,82,84,430,430,500
80,89,87,83,82,421,421,500
99,98,89,88,81,455,455,500
99,96,91,97,99,482,482,500
84,96,99,88,97,464,464,500
80,85,99,86,84,434,434,500
98,88,92,80,89,447,447,500
85,80,98,97,98,458,458,500
98,99,94,82,84,457,457,500
99,99,99,91,87,475,475,500
86,95,90,92,81,444,444,500
84,83,95,89,96,447,447,500
82,85,84,90,92,433,433,500
81,82,96,94,97,450,450,500
88,85,87,82,86,428,428,500
88,97,85,99,96,465,465,500
92,80,85,82,97,436,436,500
84,88,84,94,85,435,435,500
96,87,96,99,90,468,468,500
97,93,89,92,87,458,458,500
80,96,89,99,80,444,444,500
87,98,94,86,82,447,447,500
99,94,92,97,91,473,473,500
84,90,81,81,95,431,431,500
93,86,90,95,97,461,461,500
80,84,87,95,85,431,431,500
94,84,81,94,92,445,445,500
81,97,83,98,95,454,454,500
88,82,94,89,96,449,449,500
90,98,83,92,81,444,444,500
80,88,82,91,91,432,432,500
88,96,90,98,89,461,461,500
87,84,92,95,84,442,442,500
86,96,82,96,84,444,444,500
83,88,85,95,86,437,437,500
97,87,98,81,95,458,458,500
85,91,88,81,94,439,439,500
85,89,93,90,87,444,444,500
84,80,84,80,99,427,427,500
94,84,98,92,99,467,467,500
97,86,81,91,97,452,452,500
85,91,92,96,93,457,457,500
95,92,84,89,81,441,441,500
93,82,81,93,80,429,429,500
83,97,89,87,95,451,451,500
98,91,88,92,91,460,460,500
89,98,83,99,84,453,453,500
89,95,86,88,91,449,449,500
91,98,83,91,99,462,462,500
97,89,91,80,89,446,446,500
86,82,80,93,95,436,436,500
99,81,83,95,86,444,444,500
83,91,91,99,96,460,460,500
94,90,94,83,83,444,444,500
81,80,97,89,86,433,433,500
85,91,95,85,98,454,454,500
87,95,85,92,90,449,449,500
95,80,84,96,88,443,443,500
86,96,86,93,95,456,456,500
87,98,96,87,99,467,467,500
92,85,91,89,81,438,438,500
94,89,94,85,87,449,449,500
87,84,84,92,80,427,427,500
90,99,86,92,97,464,464,500
96,91,95,83,92,457,457,500
89,96,95,90,89,459,459,500
82,81,86,80,83,412,412,500
98,90,93,95,81,457,457,500
88,94,99,84,87,452,452,500
88,99,89,81,94,451,451,500
85,82,93,85,85,430,430,500
97,84,91,86,86,444,444,500
91,92,82,85,93,443,443,500
83,83,96,96,86,444,444,500
82,80,95,93,93,443,443,500
92,80,91,93,84,440,440,500
97,90,99,95,94,475,475,500
82,89,88,91,98,448,448,500
84,94,88,92,95,453,453,500
87,91,84,80,97,439,439,500
91,82,86,93,87,439,439,500
93,80,95,86,97,451,451,500
92,99,97,90,80,458,458,500
85,89,85,90,82,431,431,500
98,80,86,84,99,447,447,500
84,81,94,82,89,430,430,500
94,85,94,95,90,458,458,500
80,81,82,93,83,419,419,500
85,91,95,86,94,451,451,500
91,86,99,91,89,456,456,500
87,80,86,93,81,427,427,500
87,87,88,85,90,437,437,500
87,81,80,90,81,419,419,500
94,82,85,87,91,439,439,500
90,89,89,90,83,441,441,500
89,89,95,80,99,452,452,500
83,87,82,93,89,434,434,500
84,99,98,86,96,463,463,500
82,97,81,98,87,445,445,500
82,90,94,88,93,447,447,500
81,89,85,89,92,436,436,500
99,87,85,87,84,442,442,500
99,96,94,99,80,468,468,500
99,94,96,93,83,465,465,500
89,95,91,84,86,445,445,500
90,84,89,81,82,426,426,500
96,89,90,97,99,471,471,500
87,82,96,95,87,447,447,500
81,91,82,97,98,449,449,500
91,92,88,96,97,464,464,500
82,85,84,98,90,439,439,500
94,94,88,81,87,444,444,500
99,90,93,85,86,453,453,500
92,96,96,81,92,457,457,500
85,87,93,85,94,444,444,500
97,80,80,87,85,429,429,500
88,99,84,88,94,453,453,500
92,95,95,88,83,453,453,500
91,98,83,97,90,459,459,500
80,96,80,87,97,440,440,500
99,98,91,86,90,464,464,500
92,81,83,81,90,427,427,500
99,97,90,98,98,482,482,500
80,97,99,97,92,465,465,500
97,89,94,84,99,463,463,500
95,80,81,82,84,422,422,500
88,99,95,82,96,460,460,500
93,99,88,94,94,468,468,500
88,88,91,81,97,445,445,500
83,98,96,88,91,456,456,500
96,91,99,88,87,461,461,500
93,86,99,92,86,456,456,500
81,97,91,82,91,442,442,500
95,88,81,84,89,437,437,500
94,83,89,99,94,459,459,500
84,97,85,82,96,444,444,500
92,94,87,84,90,447,447,500
84,98,89,98,88,457,457,500
99,89,88,99,98,473,473,500
81,98,86,82,83,430,430,500
98,85,82,95,94,454,454,500
99,80,88,96,92,455,455,500
81,95,96,92,81,445,445,500
92,80,85,96,99,452,452,500
87,98,94,89,95,463,463,500
90,92,96,96,81,455,455,500
97,89,92,82,98,458,458,500
84,81,95,90,89,439,439,500
88,87,85,89,97,446,446,500
98,96,80,91,90,455,455,500
80,82,89,95,80,426,426,500
82,99,91,84,98,454,454,500
93,86,89,82,97,447,447,500
86,85,97,89,90,447,447,500
93,85,89,80,86,433,433,500
92,81,98,92,96,459,459,500
92,95,86,97,93,463,463,500
83,92,86,97,89,447,447,500
87,95,89,86,97,454,454,500
81,90,89,96,92,448,448,500
94,84,86,94,96,454,454,500
96,84,93,89,80,442,442,500
84,80,94,88,85,431,431,500
84,98,87,94,88,451,451,500
95,90,82,89,82,438,438,500
86,88,99,85,89,447,447,500
91,88,82,83,90,434,434,500
84,94,97,87,96,458,458,500
93,99,84,85,83,444,444,500
80,80,87,84,94,425,425,500
85,94,97,88,90,454,454,500
99,81,90,96,91,457,457,500
91,88,94,92,82,447,447,500
97,81,95,93,91,457,457,500
93,93,85,85,86,442,442,500
96,98,98,84,82,458,458,500
92,93,97,82,85,449,449,500
80,91,90,99,80,440,440,500
93,81,84,87,81,426,426,500
84,86,91,90,90,441,441,500
82,98,87,83,92,442,442,500
95,94,83,86,80,438,438,500
95,81,81,89,85,431,431,500
89,88,91,80,89,437,437,500
83,89,80,95,95,442,442,500
85,85,89,84,89,432,432,500
85,96,86,97,89,453,453,500
87,88,82,87,93,437,437,500
86,91,98,91,94,460,460,500
85,95,89,86,91,446,446,500
86,88,84,95,83,436,436,500
92,83,93,83,99,450,450,500
85,98,95,87,99,464,464,500
86,91,83,84,92,436,436,500
92,98,95,87,92,464,464,500
96,81,93,97,84,451,451,500
89,94,96,80,93,452,452,500
83,91,99,95,88,456,456,500
99,86,83,86,93,447,447,500
97,93,94,95,91,470,470,500
87,85,97,88,94,451,451,500
93,95,83,98,83,452,452,500
86,87,85,96,81,435,435,500
91,81,86,87,81,426,426,500
95,84,99,81,86,445,445,500
85,86,92,82,95,440,440,500
92,89,91,92,93,457,457,500
90,96,91,89,91,457,457,500
95,98,82,84,98,457,457,500
90,90,98,85,92,455,455,500
84,83,92,92,96,447,447,500
82,84,83,82,99,430,430,500
82,89,82,92,80,425,425,500
83,92,87,80,89,431,431,500
87,99,96,92,90,464,464,500
84,87,97,80,86,434,434,500
89,85,91,83,83,431,431,500
96,98,99,86,99,478,478,500
84,93,85,80,97,439,439,500
96,83,94,90,92,455,455,500
86,90,90,97,90,453,453,500
97,88,99,95,84,463,463,500
89,99,98,85,90,461,461,500
99,92,96,90,98,475,475,500
83,95,90,94,93,455,455,500
97,86,82,98,87,450,450,500
93,88,80,97,91,449,449,500
94,88,83,89,97,451,451,500
81,96,88,82,85,432,432,500
99,80,96,97,94,466,466,500
95,94,95,97,87,468,468,500
93,91,99,84,91,458,458,500
91,93,91,88,83,446,446,500
83,83,89,85,81,421,421,500
80,89,91,95,85,440,440,500
98,80,95,87,98,458,458,500
86,89,93,81,88,437,437,500
90,90,81,92,82,435,435,500
98,87,81,96,81,443,443,500
91,85,85,99,86,446,446,500
96,84,91,95,89,455,455,500
99,95,82,96,88,460,460,500
89,99,88,84,82,442,442,500
84,83,82,84,99,432,432,500
81,87,86,91,99,444,444,500
84,80,88,95,94,441,441,500
82,97,83,89,90,441,441,500
93,97,80,85,96,451,451,500
95,90,87,88,81,441,441,500
90,82,84,95,80,431,431,500
98,89,93,97,83,460,460,500
99,93,87,99,86,464,464,500
96,84,85,99,81,445,445,500
95,87,84,91,82,439,439,500
98,86,80,98,87,449,449,500
87,91,96,88,88,450,450,500
95,91,86,85,83,440,440,500
92,96,97,89,86,460,460,500
95,97,81,84,88,445,445,500
81,85,91,93,85,435,435,500
89,85,91,89,92,446,446,500
82,87,90,92,84,435,435,500
97,92,84,80,84,437,437,500
89,81,81,82,82,415,415,500
93,80,85,80,89,427,427,500
95,99,97,89,92,472,472,500
96,89,99,91,97,472,472,500
83,96,86,91,86,442,442,500
96,89,89,95,84,453,453,500
97,95,96,97,83,468,468,500
97,97,84,82,84,444,444,500
95,98,95,80,89,457,457,500
89,83,82,98,82,434,434,500
80,83,88,87,89,427,427,500
85,94,87,93,96,455,455,500
88,97,90,81,95,451,451,500
94,81,98,88,82,443,443,500
96,93,91,80,98,458,458,500
87,94,87,81,91,440,440,500
84,97,96,86,98,461,461,500
99,85,98,82,96,460,460,500
95,99,91,81,84,450,450,500
98,83,97,92,94,464,464,500
82,93,84,98,83,440,440,500
82,97,80,99,93,451,451,500
84,98,85,96,93,456,456,500
88,95,91,85,89,448,448,500
92,94,82,98,93,459,459,500
97,94,98,95,94,478,478,500
90,93,98,81,85,447,447,500
91,84,96,81,99,451,451,500
83,83,90,91,91,438,438,500
82,92,93,96,85,448,448,500
98,95,94,82,87,456,456,500
97,82,97,88,87,451,451,500
95,88,81,95,89,448,448,500
91,95,94,93,91,464,464,500
96,89,98,90,83,456,456,500
91,84,88,86,83,432,432,500
81,94,87,96,82,440,440,500
91,92,91,93,94,461,461,500
94,91,86,82,96,449,449,500
81,80,96,98,98,453,453,500
89,86,96,94,88,453,453,500
97,93,80,94,99,463,463,500
94,81,83,96,93,447,447,500
96,94,84,90,97,461,461,500
84,85,86,92,88,435,435,500
83,89,82,90,81,425,425,500
99,93,95,95,86,468,468,500
97,82,81,91,95,446,446,500
91,91,94,92,98,466,466,500
99,94,95,86,88,462,462,500
94,96,81,95,94,460,460,500
86,91,87,89,90,443,443,500
86,97,91,83,97,454,454,500
89,83,97,81,83,433,433,500
96,86,81,83,87,433,433,500
87,94,94,83,89,447,447,500
94,89,92,88,86,449,449,500
92,83,98,95,94,462,462,500
90,98,98,82,82,450,450,500
97,84,97,93,85,456,456,500
90,81,88,87,90,436,436,500
98,95,97,96,82,468,468,500
93,95,98,89,87,462,462,500
86,90,91,83,94,444,444,500
86,93,81,92,87,439,439,500
80,87,82,83,94,426,426,500
83,86,90,91,91,441,441,500
84,88,81,80,85,418,418,500
82,91,83,90,84,430,430,500
81,88,83,91,98,441,441,500
93,89,83,86,84,435,435,500
82,80,97,92,85,436,436,500
80,93,96,81,92,442,442,500
89,96,94,98,97,474,474,500
83,82,88,80,97,430,430,500
83,99,85,96,87,450,450,500
96,91,87,89,98,461,461,500
80,86,82,81,93,422,422,500
83,81,89,88,82,423,423,500
95,83,97,96,99,470,470,500
85,83,89,88,81,426,426,500
86,93,92,96,92,459,459,500
88,88,88,96,93,453,453,500
85,84,89,88,85,431,431,500
81,97,90,91,84,443,443,500
85,95,96,95,83,454,454,500
93,84,87,98,95,457,457,500
93,80,96,87,80,436,436,500
81,94,83,81,88,427,427,500
95,86,86,91,92,450,450,500
88,87,80,82,97,434,434,500
99,89,84,81,97,450,450,500
93,91,89,86,85,444,444,500
97,80,86,89,82,434,434,500
99,97,88,84,83,451,451,500
94,80,94,85,91,444,444,500
80,86,97,98,82,443,443,500
85,99,85,89,86,444,444,500
83,98,91,86,89,447,447,500
87,86,85,85,96,439,439,500
90,80,80,91,99,440,440,500
97,96,95,98,81,467,467,500
99,98,94,94,81,466,466,500
84,97,92,83,95,451,451,500
91,88,92,95,89,455,455,500
93,99,85,93,88,458,458,500
82,81,98,87,97,445,445,500
87,95,95,91,97,465,465,500
91,83,92,87,95,448,448,500
86,90,89,96,94,455,455,500
82,81,88,89,94,434,434,500
83,81,82,86,97,429,429,500
96,99,81,95,80,451,451,500
82,93,86,89,96,446,446,500
81,93,86,92,93,445,445,500
82,98,85,90,96,451,451,500
87,83,93,94,94,451,451,500
90,89,99,81,85,444,444,500
99,82,85,84,98,448,448,500
88,83,86,97,90,444,444,500
87,98,84,86,94,449,449,500
99,97,97,84,92,469,469,500
96,83,86,95,96,456,456,500
87,86,96,83,80,432,432,500
92,88,99,91,80,450,450,500
90,95,80,99,80,444,444,500
80,81,93,88,99,441,441,500
89,80,90,83,84,426,426,500
90,94,85,96,96,461,461,500
88,82,80,97,84,431,431,500
84,90,82,82,80,418,418,500
94,93,93,92,87,459,459,500
89,86,96,90,91,452,452,500
83,88,90,93,82,436,436,500
93,80,84,93,95,445,445,500
80,90,87,90,82,429,429,500
97,95,96,92,91,471,471,500
99,99,85,81,95,459,459,500
82,92,96,86,99,455,455,500
81,92,88,90,84,435,435,500
97,93,96,92,94,472,472,500
82,97,80,82,91,432,432,500
98,93,80,94,80,445,445,500
90,99,94,91,95,469,469,500
92,82,81,86,91,432,432,500
91,90,99,88,93,461,461,500
96,88,83,92,92,451,451,500
80,86,93,84,94,437,437,500
98,86,97,91,90,462,462,500
82,97,94,88,95,456,456,500
94,86,99,93,99,471,471,500
99,93,97,92,89,470,470,500
90,88,89,85,99,451,451,500
86,94,80,95,84,439,439,500
90,90,99,94,84,457,457,500
98,85,89,88,91,451,451,500
85,92,99,97,89,462,462,500
98,82,85,93,82,440,440,500
98,98,90,89,88,463,463,500
96,85,84,82,92,439,439,500
86,99,87,91,82,445,445,500
84,86,97,97,89,453,453,500
88,84,87,85,87,431,431,500
81,97,88,86,89,441,441,500
85,97,92,96,85,455,455,500
94,90,91,82,91,448,448,500
85,84,91,91,90,441,441,500
82,84,90,97,83,436,436,500
93,84,90,88,83,438,438,500
99,87,98,83,98,465,465,500
89,88,98,95,94,464,464,500
98,88,98,80,90,454,454,500
95,95,92,85,84,451,451,500
90,85,80,87,98,440,440,500
97,80,90,84,80,431,431,500
87,93,89,92,89,450,450,500
89,96,96,81,83,445,445,500
82,80,98,83,84,427,427,500
88,85,84,94,93,444,444,500
81,93,93,98,92,457,457,500
89,81,94,83,81,428,428,500
91,81,95,97,95,459,459,500
96,81,81,83,85,426,426,500
92,80,80,98,88,438,438,500
80,90,89,93,83,435,435,500
94,93,91,92,99,469,469,500
94,99,83,81,80,437,437,500
81,93,94,81,83,432,432,500
88,89,85,94,88,444,444,500
88,97,86,93,96,460,460,500
80,88,90,87,86,431,431,500
84,81,91,80,99,435,435,500
99,98,89,99,91,476,476,500
86,83,93,95,97,454,454,500
89,80,81,93,97,440,440,500
86,95,93,89,86,449,449,500
81,82,86,92,91,432,432,500
90,89,80,91,99,449,449,500
80,83,95,92,90,440,440,500
84,83,99,94,98,458,458,500
95,91,90,86,85,447,447,500
96,90,94,98,80,458,458,500
90,81,93,93,83,440,440,500
98,94,80,91,96,459,459,500
89,89,99,97,88,462,462,500
90,80,89,97,82,438,438,500
89,87,99,93,86,454,454,500
87,86,98,98,97,466,466,500
90,96,80,90,88,444,444,500
91,93,97,92,96,469,469,500
99,83,88,89,98,457,457,500
92,83,94,91,88,448,448,500
86,81,91,94,92,444,444,500
85,95,91,91,97,459,459,500
86,96,90,89,83,444,444,500
86,86,98,81,81,432,432,500
95,87,99,82,93,456,456,500
90,98,89,93,87,457,457,500
88,87,83,92,88,438,438,500
93,98,98,84,84,457,457,500
99,83,94,90,99,465,465,500
85,85,93,81,80,424,424,500
91,95,88,88,83,445,445,500
96,80,99,87,87,449,449,500
86,96,97,84,92,455,455,500
93,86,86,84,97,446,446,500
90,84,86,89,93,442,442,500
92,81,86,81,84,424,424,500
89,91,87,89,95,451,451,500
92,89,91,84,93,449,449,500
81,81,96,83,94,435,435,500
85,99,93,83,83,443,443,500
87,90,85,82,94,438,438,500
85,94,90,89,90,448,448,500
83,85,83,84,95,430,430,500
87,99,98,82,95,461,461,500
99,83,82,81,81,426,426,500
93,92,81,88,82,436,436,500
97,88,82,93,83,443,443,500
91,86,98,96,89,460,460,500
86,95,83,87,99,450,450,500
85,96,81,85,96,443,443,500
95,90,82,91,87,445,445,500
88,85,94,81,98,446,446,500
83,95,91,84,97,450,450,500
96,87,92,85,98,458,458,500
90,96,99,92,88,465,465,500
92,80,90,90,93,445,445,500
89,84,98,95,84,450,450,500
93,81,92,87,93,446,446,500
98,92,84,81,85,440,440,500
80,86,87,89,89,431,431,500
80,84,90,91,86,431,431,500
85,81,82,97,87,432,432,500
90,90,85,83,84,432,432,500
82,86,97,81,90,436,436,500
95,97,83,94,95,464,464,500
97,97,98,97,98,487,487,500
92,92,86,87,93,450,450,500
99,99,99,98,96,491,491,500
84,99,95,86,88,452,452,500
91,86,92,81,85,435,435,500
81,99,99,91,91,461,461,500
80,95,86,88,85,434,434,500
82,83,99,85,89,438,438,500
87,82,83,91,85,428,428,500
99,81,90,88,84,442,442,500
94,82,85,99,87,447,447,500
96,88,92,82,90,448,448,500
85,90,85,87,93,440,440,500
93,92,92,92,95,464,464,500
86,90,98,82,87,443,443,500
81,93,96,94,91,455,455,500
93,81,83,99,86,442,442,500
92,98,83,88,93,454,454,500
93,91,86,96,91,457,457,500
97,91,90,84,95,457,457,500
85,87,82,80,89,423,423,500
94,86,91,96,93,460,460,500
83,81,95,91,99,449,449,500
81,90,85,99,95,450,450,500
95,95,97,91,95,473,473,500
87,86,80,84,83,420,420,500
93,87,99,80,90,449,449,500
80,83,82,87,86,418,418,500
92,97,98,94,83,464,464,500
95,81,96,97,85,454,454,500
89,82,92,85,84,432,432,500
83,99,91,82,91,446,446,500
84,94,85,88,85,436,436,500
87,93,85,93,82,440,440,500
83,80,93,89,91,436,436,500
81,96,88,98,84,447,447,500
96,81,95,83,98,453,453,500
89,82,94,86,99,450,450,500
97,98,91,94,80,460,460,500
94,98,95,95,93,475,475,500
98,91,93,87,89,458,458,500
82,84,80,97,85,428,428,500
82,81,85,94,95,437,437,500
80,92,93,80,81,426,426,500
96,91,85,88,84,444,444,500
92,81,88,88,83,432,432,500
94,94,82,88,89,447,447,500
86,96,89,92,81,444,444,500
93,88,82,97,88,448,448,500
94,96,84,89,81,444,444,500
96,96,97,99,92,480,480,500
84,98,93,98,92,465,465,500
81,86,95,91,82,435,435,500
83,84,89,88,89,433,433,500
99,86,81,93,99,458,458,500
82,83,91,95,88,439,439,500
88,85,95,80,80,428,428,500
96,98,85,88,90,457,457,500
95,88,86,97,86,452,452,500
90,81,96,88,89,444,444,500
97,99,85,82,80,443,443,500
81,84,92,86,96,439,439,500
99,93,82,81,81,436,436,500
87,98,85,88,80,438,438,500
92,90,92,86,91,451,451,500
88,91,97,95,81,452,452,500
98,97,93,94,99,481,481,500
87,89,96,82,95,449,449,500
88,90,82,88,99,447,447,500
95,89,89,98,90,461,461,500
87,96,81,92,86,442,442,500
93,97,86,90,97,463,463,500
81,96,89,81,85,432,432,500
93,96,81,89,90,449,449,500
86,94,82,97,94,453,453,500
88,88,82,80,81,419,419,500
80,90,90,95,90,445,445,500
84,93,81,96,85,439,439,500
96,80,80,96,95,447,447,500
99,86,85,87,94,451,451,500
89,92,97,84,81,443,443,500
88,91,95,94,96,464,464,500
96,88,99,97,88,468,468,500
80,90,88,96,84,438,438,500
92,89,85,96,83,445,445,500
97,91,91,90,86,455,455,500
84,81,87,93,99,444,444,500
92,84,91,84,87,438,438,500
80,99,95,84,83,441,441,500
80,98,92,82,99,451,451,500
80,91,84,94,81,430,430,500
94,80,91,92,97,454,454,500
85,88,96,80,86,435,435,500
88,98,80,83,88,437,437,500
96,85,86,89,97,453,453,500
94,86,97,83,96,456,456,500
84,93,86,99,80,442,442,500
80,91,85,83,80,419,419,500
94,88,82,92,87,443,443,500
95,90,89,83,83,440,440,500
92,82,98,94,87,453,453,500
99,92,88,94,85,458,458,500
88,89,89,85,98,449,449,500
90,84,95,81,81,431,431,500
85,94,99,87,99,464,464,500
97,92,88,96,94,467,467,500
90,85,83,92,83,433,433,500
95,81,85,86,84,431,431,500
83,83,82,82,97,427,427,500
91,95,85,95,95,461,461,500
81,98,93,88,93,453,453,500
88,94,87,88,89,446,446,500
86,81,90,91,93,441,441,500
94,92,96,81,96,459,459,500
96,94,84,87,97,458,458,500
98,98,90,87,90,463,463,500
92,89,86,94,93,454,454,500
94,83,86,80,83,426,426,500
92,85,82,80,88,427,427,500
92,88,87,84,83,434,434,500
86,99,97,91,82,455,455,500
87,88,97,87,91,450,450,500
81,83,80,98,81,423,423,500
84,90,92,89,81,436,436,500
90,96,85,94,85,450,450,500
89,97,95,98,83,462,462,500
95,80,86,95,95,451,451,500
84,80,84,94,89,431,431,500
96,96,96,97,80,465,465,500
99,92,81,90,89,451,451,500
81,84,99,89,92,445,445,500
95,87,86,88,90,446,446,500
89,92,90,86,89,446,446,500
91,82,95,97,92,457,457,500
88,90,82,91,86,437,437,500
87,91,95,80,89,442,442,500
85,96,98,93,86,458,458,500
85,80,99,91,81,436,436,500
89,99,92,92,90,462,462,500
97,87,96,82,82,444,444,500
82,81,83,85,98,429,429,500
85,99,98,94,99,475,475,500
97,83,98,90,82,450,450,500
86,86,91,82,85,430,430,500
82,85,91,89,82,429,429,500
97,94,96,97,84,468,468,500
80,96,98,96,84,454,454,500
99,89,93,82,85,448,448,500
97,90,99,99,81,466,466,500
92,99,91,92,86,460,460,500
83,93,83,85,90,434,434,500
94,87,90,95,99,465,465,500
98,87,94,89,89,457,457,500
91,95,99,84,84,453,453,500
90,93,80,94,81,438,438,500
93,88,91,94,91,457,457,500
96,91,93,97,98,475,475,500
84,81,84,89,96,434,434,500
92,99,90,94,81,456,456,500
87,96,86,81,89,439,439,500
86,88,98,88,94,454,454,500
81,86,83,80,92,422,422,500
82,89,88,96,83,438,438,500
80,82,81,82,91,416,416,500
90,89,93,92,81,445,445,500
99,90,97,91,84,461,461,500
80,93,87,97,90,447,447,500
97,92,94,80,87,450,450,500
97,82,87,96,87,449,449,500
87,80,92,99,87,445,445,500
97,81,88,98,89,453,453,500
99,80,89,92,90,450,450,500
96,90,91,92,92,461,461,500
85,82,91,97,99,454,454,500
89,85,84,94,98,450,450,500
93,99,84,90,92,458,458,500
89,90,91,97,98,465,465,500
97,86,92,84,81,440,440,500
81,96,80,95,83,435,435,500
84,82,87,97,80,430,430,500
82,86,91,90,94,443,443,500
85,83,85,99,99,451,451,500
97,93,86,81,90,447,447,500
93,93,80,89,83,438,438,500
89,90,84,90,85,438,438,500
97,89,81,81,98,446,446,500
83,98,92,86,91,450,450,500
84,89,88,84,91,436,436,500
98,96,98,97,96,485,485,500
98,94,88,83,98,461,461,500
99,82,90,97,88,456,456,500
88,87,86,82,98,441,441,500
84,87,84,94,87,436,436,500
81,93,99,96,99,468,468,500
82,99,94,87,94,456,456,500
86,81,93,92,87,439,439,500
97,89,80,84,96,446,446,500
96,92,91,97,90,466,466,500
96,83,82,80,84,425,425,500
85,81,82,99,86,433,433,500
99,95,97,95,86,472,472,500
92,83,91,83,95,444,444,500
83,86,94,96,94,453,453,500
90,98,81,90,96,455,455,500
97,89,97,84,88,455,455,500
97,87,90,87,91,452,452,500
89,84,95,91,92,451,451,500
98,86,93,88,90,455,455,500
91,92,86,80,81,430,430,500
91,98,98,96,80,463,463,500
81,99,93,89,99,461,461,500
85,96,89,81,94,445,445,500
97,83,82,85,86,433,433,500
83,85,82,86,93,429,429,500
98,84,99,97,90,468,468,500
93,87,94,90,89,453,453,500
89,94,81,99,80,443,443,500
96,81,95,90,84,446,446,500
95,90,86,81,98,450,450,500
99,90,99,97,81,466,466,500
94,91,81,81,94,441,441,500
89,88,81,97,83,438,438,500
85,96,80,95,80,436,436,500
88,93,92,93,83,449,449,500
91,97,88,91,96,463,463,500
87,81,98,88,92,446,446,500
89,91,98,91,83,452,452,500
94,88,96,94,99,471,471,500
98,85,82,82,91,438,438,500
95,98,85,98,85,461,461,500
86,93,90,82,84,435,435,500
82,94,83,95,95,449,449,500
94,83,99,83,88,447,447,500
96,85,86,81,80,428,428,500
88,96,89,82,85,440,440,500
93,81,90,83,86,433,433,500
99,80,82,83,80,424,424,500
98,91,99,87,92,467,467,500
86,81,80,87,84,418,418,500
99,97,84,98,80,458,458,500
95,90,93,87,87,452,452,500
86,93,96,84,97,456,456,500
96,84,92,92,91,455,455,500
90,90,81,94,91,446,446,500
97,99,87,95,84,462,462,500
84,84,83,80,94,425,425,500
80,90,98,98,92,458,458,500
85,91,83,86,88,433,433,500
83,84,97,89,97,450,450,500
93,94,90,91,92,460,460,500
94,99,88,85,93,459,459,500
87,96,93,90,94,460,460,500
91,94,81,87,96,449,449,500
99,89,92,92,82,454,454,500
95,98,99,89,97,478,478,500
93,80,97,83,84,437,437,500
92,87,91,99,82,451,451,500
84,92,82,96,89,443,443,500
85,81,98,82,90,436,436,500
88,84,89,90,99,450,450,500
86,82,97,89,91,445,445,500
82,93,86,86,88,435,435,500
91,91,82,84,80,428,428,500
88,88,83,80,96,435,435,500
91,95,93,80,95,454,454,500
89,83,80,84,93,429,429,500
87,89,86,97,98,457,457,500
93,81,83,85,81,423,423,500
85,95,86,82,81,429,429,500
86,92,91,83,83,435,435,500
83,91,83,97,90,444,444,500
89,80,92,95,87,443,443,500
84,84,93,90,89,440,440,500
94,89,97,89,90,459,459,500
96,80,86,90,82,434,434,500
85,99,96,92,92,464,464,500
93,89,84,87,96,449,449,500
83,99,82,82,89,435,435,500
84,82,93,88,91,438,438,500
80,98,91,88,96,453,453,500
84,86,84,85,92,431,431,500
93,92,95,93,90,463,463,500
82,81,94,87,85,429,429,500
90,91,85,84,98,448,448,500
97,85,95,90,83,450,450,500
95,94,81,80,80,430,430,500
88,87,94,82,94,445,445,500
89,98,93,83,81,444,444,500
92,89,88,90,96,455,455,500
92,89,88,87,80,436,436,500
80,95,86,87,94,442,442,500
96,81,96,91,87,451,451,500
83,87,86,80,98,434,434,500
84,87,89,92,84,436,436,500
96,84,86,89,86,441,441,500
84,84,83,80,95,426,426,500
99,97,84,95,97,472,472,500
86,91,82,97,92,448,448,500
94,82,81,95,82,434,434,500
82,90,85,97,85,439,439,500
89,93,90,82,84,438,438,500
86,91,90,94,88,449,449,500
87,96,94,90,88,455,455,500
92,80,96,84,95,447,447,500
88,86,83,89,84,430,430,500
99,80,87,90,91,447,447,500
94,86,88,98,97,463,463,500
86,83,90,83,87,429,429,500
87,96,83,96,91,453,453,500
96,94,92,94,88,464,464,500
86,96,84,99,81,446,446,500
80,96,98,92,82,448,448,500
80,81,81,93,84,419,419,500
82,85,91,85,81,424,424,500
84,83,98,93,81,439,439,500
95,87,93,82,85,442,442,500
85,94,93,85,94,451,451,500
88,85,91,89,86,439,439,500
83,82,93,98,93,449,449,500
94,83,82,98,95,452,452,500
80,85,92,91,83,431,431,500
88,85,88,87,88,436,436,500
95,93,97,84,83,452,452,500
92,93,82,88,87,442,442,500
88,89,92,91,88,448,448,500
84,89,92,90,92,447,447,500
89,83,80,85,95,432,432,500
98,98,90,94,82,462,462,500
98,81,89,99,96,463,463,500
95,83,80,90,86,434,434,500
97,80,80,93,81,431,431,500
94,87,94,97,90,462,462,500
82,86,88,90,95,441,441,500
94,87,96,93,86,456,456,500
93,97,82,97,85,454,454,500
88,84,92,94,97,455,455,500
94,99,92,86,91,462,462,500
94,82,83,85,96,440,440,500
81,84,80,96,87,428,428,500
87,99,91,86,89,452,452,500
89,95,94,84,96,458,458,500
90,87,94,93,89,453,453,500
80,81,87,97,84,429,429,500
97,83,90,85,99,454,454,500
96,97,82,93,95,463,463,500
98,84,88,93,94,457,457,500
94,86,96,82,82,440,440,500
95,99,90,96,85,465,465,500
84,99,94,89,82,448,448,500
87,95,88,89,90,449,449,500
85,85,86,80,94,430,430,500
91,94,83,83,92,443,443,500
94,95,99,84,90,462,462,500
89,80,97,89,95,450,450,500
91,82,89,88,89,439,439,500
93,85,84,80,93,435,435,500
97,93,88,86,85,449,449,500
89,95,94,81,85,444,444,500
96,84,90,90,87,447,447,500
86,93,88,93,91,451,451,500
94,81,94,90,87,446,446,500
93,96,94,91,99,473,473,500
99,89,84,91,95,458,458,500
91,94,92,96,85,458,458,500
93,89,81,93,91,447,447,500
84,86,80,83,85,418,418,500
98,96,87,86,83,450,450,500
93,80,97,80,89,439,439,500
84,97,84,85,93,443,443,500
84,80,98,91,87,440,440,500
81,83,98,83,97,442,442,500
92,88,82,99,85,446,446,500
84,81,89,84,83,421,421,500
83,83,84,80,82,412,412,500
96,80,81,80,84,421,421,500
84,98,95,86,88,451,451,500
92,86,95,98,97,468,468,500
89,97,81,97,89,453,453,500
82,97,90,90,89,448,448,500
85,80,82,84,89,420,420,500
98,89,86,94,80,447,447,500
84,94,85,93,97,453,453,500
95,87,98,84,99,463,463,500
82,95,92,80,86,435,435,500
86,99,84,94,93,456,456,500
91,82,86,99,99,457,457,500
99,97,89,97,85,467,467,500
84,94,88,88,87,441,441,500
89,83,86,83,86,427,427,500
81,84,91,91,84,431,431,500
97,86,92,87,97,459,459,500
84,85,99,94,82,444,444,500
81,81,86,85,88,421,421,500
94,81,87,97,88,447,447,500
99,95,92,91,93,470,470,500
89,93,95,86,91,454,454,500
88,94,95,96,92,465,465,500
97,97,83,84,95,456,456,500
87,82,81,85,95,430,430,500
95,84,91,88,92,450,450,500
98,95,84,84,92,453,453,500
84,82,86,98,94,444,444,500
98,94,92,87,80,451,451,500
92,96,83,82,91,444,444,500
96,85,90,99,94,464,464,500
91,80,92,91,80,434,434,500
92,81,91,93,86,443,443,500
98,91,95,86,97,467,467,500
94,94,94,95,98,475,475,500
90,82,96,90,85,443,443,500
95,89,93,98,98,473,473,500
85,88,98,91,92,454,454,500
88,87,97,97,85,454,454,500
98,81,94,99,99,471,471,500
97,85,87,86,92,447,447,500
89,89,81,98,85,442,442,500
99,92,94,81,99,465,465,500
85,90,98,80,82,435,435,500
88,99,82,99,91,459,459,500
83,91,86,83,81,424,424,500
84,88,85,93,90,440,440,500
95,80,90,98,84,447,447,500
90,99,93,90,95,467,467,500
80,80,83,97,98,438,438,500
85,97,80,96,85,443,443,500
99,86,81,81,85,432,432,500
82,87,82,85,87,423,423,500
83,82,97,98,86,446,446,500
91,86,85,96,90,448,448,500
98,93,86,80,89,446,446,500
81,81,95,87,93,437,437,500
90,92,82,89,97,450,450,500
85,83,84,94,90,436,436,500
91,84,86,84,81,426,426,500
89,93,95,96,81,454,454,500
83,98,98,85,87,451,451,500
83,99,81,86,85,434,434,500
82,95,97,80,98,452,452,500
88,96,83,96,81,444,444,500
90,85,85,80,82,422,422,500
87,91,83,93,93,447,447,500
95,85,92,90,95,457,457,500
84,93,94,92,99,462,462,500
81,90,81,87,85,424,424,500
86,80,81,86,96,429,429,500
88,98,81,94,80,441,441,500
92,99,92,93,85,461,461,500
97,80,88,98,96,459,459,500
88,92,81,85,87,433,433,500
92,87,87,88,85,439,439,500
98,84,83,93,98,456,456,500
86,82,95,97,96,456,456,500
82,89,89,90,84,434,434,500
85,83,91,98,98,455,455,500
97,83,92,98,88,458,458,500
85,89,96,82,97,449,449,500
94,86,91,94,83,448,448,500
94,85,84,91,90,444,444,500
82,89,80,92,97,440,440,500
90,87,91,85,81,434,434,500
92,99,86,97,83,457,457,500
94,93,82,82,80,431,431,500
99,80,83,95,91,448,448,500
82,80,82,94,99,437,437,500
97,84,92,85,97,455,455,500
86,91,92,82,81,432,432,500
90,84,93,84,80,431,431,500
86,80,83,88,98,435,435,500
85,81,93,88,98,445,445,500
83,82,87,92,86,430,430,500
96,92,98,86,86,458,458,500
93,92,84,91,97,457,457,500
97,97,85,98,86,463,463,500
85,84,97,91,97,454,454,500
94,99,90,95,89,467,467,500
91,92,87,95,92,457,457,500
83,96,94,97,86,456,456,500
89,96,97,99,87,468,468,500
89,99,99,84,90,461,461,500
94,97,99,98,95,483,483,500
80,81,93,80,83,417,417,500
87,82,80,90,86,425,425,500
80,90,84,91,92,437,437,500
88,85,94,80,97,444,444,500
93,83,92,93,87,448,448,500
96,81,89,96,96,458,458,500
94,82,83,83,85,427,427,500
95,93,81,88,85,442,442,500
91,99,85,98,80,453,453,500
91,82,96,82,83,434,434,500
99,91,90,80,99,459,459,500
90,80,92,92,81,435,435,500
92,88,96,98,94,468,468,500
94,98,87,99,80,458,458,500
95,94,85,99,88,461,461,500
94,88,85,96,86,449,449,500
84,94,92,83,87,440,440,500
85,89,91,89,80,434,434,500
98,82,96,84,83,443,443,500
80,98,89,84,91,442,442,500
95,91,95,94,87,462,462,500
85,87,90,83,81,426,426,500
88,94,85,98,96,461,461,500
88,86,98,81,84,437,437,500
84,95,96,99,98,472,472,500
94,81,88,81,89,433,433,500
85,81,88,94,96,444,444,500
84,84,95,96,90,449,449,500
86,91,87,90,95,449,449,500
95,84,93,94,88,454,454,500
89,86,90,99,87,451,451,500
99,81,97,93,86,456,456,500
91,94,81,93,80,439,439,500
98,90,82,81,86,437,437,500
98,93,90,92,97,470,470,500
84,91,96,87,90,448,448,500
97,96,98,97,86,474,474,500
93,81,92,96,90,452,452,500
93,92,80,98,95,458,458,500
90,86,96,92,90,454,454,500
84,93,92,99,85,453,453,500
82,80,80,82,87,411,411,500
95,83,98,99,88,463,463,500
81,93,80,93,90,437,437,500
86,95,81,93,95,450,450,500
97,87,81,84,84,433,433,500
88,89,92,87,98,454,454,500
95,84,84,81,88,432,432,500
95,83,88,97,89,452,452,500
96,83,93,97,85,454,454,500
99,84,93,96,81,453,453,500
84,93,83,80,86,426,426,500
86,94,80,90,84,434,434,500
91,92,95,94,81,453,453,500
89,87,93,96,87,452,452,500
86,91,80,90,98,445,445,500
80,87,95,99,88,449,449,500
80,88,98,89,85,440,440,500
86,81,99,98,90,454,454,500
84,80,97,80,98,439,439,500
87,83,91,99,91,451,451,500
90,95,84,88,88,445,445,500
82,95,85,85,88,435,435,500
88,99,91,95,94,467,467,500
83,84,81,84,89,421,421,500
92,90,86,86,81,435,435,500
80,99,93,83,99,454,454,500
95,83,87,83,94,442,442,500
86,95,89,89,99,458,458,500
97,97,82,95,89,460,460,500
90,98,86,98,83,455,455,500
96,91,85,99,89,460,460,500
89,89,95,93,93,459,459,500
96,87,88,86,96,453,453,500
81,83,89,94,92,439,439,500
85,90,90,89,99,453,453,500
85,84,97,85,82,433,433,500
83,96,93,82,94,448,448,500
92,85,96,92,86,451,451,500
85,95,95,87,81,443,443,500
92,96,94,97,88,467,467,500
96,90,98,96,97,477,477,500
84,83,86,91,86,430,430,500
92,96,90,84,97,459,459,500
86,96,99,85,82,448,448,500
88,94,95,81,90,448,448,500
91,96,80,82,96,445,445,500
86,85,95,98,88,452,452,500
89,80,99,86,96,450,450,500
93,99,90,84,83,449,449,500
94,97,88,85,85,449,449,500
92,80,90,88,80,430,430,500
94,97,92,91,94,468,468,500
82,86,94,88,86,436,436,500
92,87,98,96,94,467,467,500
86,92,93,92,95,458,458,500
90,88,99,82,96,455,455,500
96,99,84,95,85,459,459,500
91,93,85,80,95,444,444,500
97,96,91,85,96,465,465,500
93,91,89,90,85,448,448,500
85,95,99,93,91,463,463,500
85,92,85,80,99,441,441,500
99,96,90,80,85,450,450,500
90,96,86,80,80,432,432,500
92,84,87,82,92,437,437,500
84,86,93,80,88,431,431,500
89,94,94,83,90,450,450,500
95,95,97,85,89,461,461,500
92,86,96,91,87,452,452,500
94,80,82,97,91,444,444,500
91,81,89,89,80,430,430,500
82,92,98,89,90,451,451,500
96,83,83,84,91,437,437,500
95,83,92,86,89,445,445,500
96,87,88,85,97,453,453,500
91,99,86,98,82,456,456,500
91,83,81,86,81,422,422,500
80,93,99,87,82,441,441,500
96,98,98,98,91,481,481,500
99,90,80,91,92,452,452,500
80,89,93,92,93,447,447,500
97,84,80,90,90,441,441,500
92,80,90,81,96,439,439,500
98,82,90,87,82,439,439,500
82,96,86,91,94,449,449,500
94,88,93,80,90,445,445,500
88,88,99,88,92,455,455,500
88,89,83,82,93,435,435,500
91,86,99,98,96,470,470,500
84,83,95,91,97,450,450,500
94,86,81,81,81,423,423,500
89,99,96,84,87,455,455,500
80,93,91,93,81,438,438,500
89,80,85,83,85,422,422,500
81,90,87,97,83,438,438,500
93,98,96,92,90,469,469,500
99,99,98,81,87,464,464,500
88,96,95,83,91,453,453,500
91,89,94,88,98,460,460,500
97,92,80,95,81,445,445,500
92,85,94,88,93,452,452,500
82,89,81,92,80,424,424,500
96,80,92,81,91,440,440,500
86,84,93,86,89,438,438,500
91,89,98,99,94,471,471,500
98,93,89,96,95,471,471,500
99,92,85,87,91,454,454,500
84,84,97,98,89,452,452,500
80,97,96,81,82,436,436,500
92,81,96,90,86,445,445,500
82,90,93,99,98,462,462,500
96,84,86,86,86,438,438,500
80,82,88,87,82,419,419,500
87,91,90,87,96,451,451,500
88,99,87,82,83,439,439,500
94,83,80,96,89,442,442,500
86,83,82,95,80,426,426,500
89,92,98,88,92,459,459,500
93,97,89,88,89,456,456,500
99,81,80,91,92,443,443,500
97,98,81,91,83,450,450,500
91,88,88,88,81,436,436,500
86,81,84,90,85,426,426,500
88,84,97,81,82,432,432,500
80,89,90,93,97,449,449,500
95,98,91,86,97,467,467,500
90,88,92,95,92,457,457,500
87,82,93,94,91,447,447,500
96,93,99,92,94,474,474,500
87,89,81,97,86,440,440,500
88,93,85,95,87,448,448,500
89,88,97,89,86,449,449,500
95,95,91,96,91,468,468,500
99,82,94,82,82,439,439,500
83,97,89,98,84,451,451,500
89,85,90,98,95,457,457,500
96,90,80,82,85,433,433,500
92,96,93,80,85,446,446,500
83,84,81,85,90,423,423,500
90,90,99,81,89,449,449,500
96,97,80,91,90,454,454,500
84,97,97,97,86,461,461,500
81,84,92,90,94,441,441,500
95,92,90,89,84,450,450,500
84,83,90,85,96,438,438,500
84,99,95,82,91,451,451,500
97,86,80,81,81,425,425,500
92,95,96,93,93,469,469,500
86,87,87,98,99,457,457,500
96,90,84,97,80,447,447,500
93,85,91,81,97,447,447,500
99,88,86,86,95,454,454,500
82,84,91,92,94,443,443,500
82,85,81,82,93,423,423,500
98,88,85,96,98,465,465,500
94,98,97,98,99,486,486,500
93,81,83,84,98,439,439,500
82,99,80,80,83,424,424,500
99,88,86,85,97,455,455,500
83,85,80,83,99,430,430,500
83,95,97,89,92,456,456,500
84,81,92,96,97,450,450,500
93,87,83,92,92,447,447,500
83,97,94,96,85,455,455,500
90,98,98,97,86,469,469,500
91,99,83,81,83,437,437,500
88,86,92,94,99,459,459,500
85,95,97,86,90,453,453,500
83,87,84,88,98,440,440,500
91,98,98,82,92,461,461,500
90,91,83,84,94,442,442,500
85,92,85,91,81,434,434,500
82,97,97,86,95,457,457,500
97,99,98,92,82,468,468,500
96,98,82,82,82,440,440,500
98,95,85,84,81,443,443,500
84,93,98,85,99,459,459,500
87,92,80,86,98,443,443,500
80,82,92,99,81,434,434,500
80,90,88,95,90,443,443,500
98,92,89,91,97,467,467,500
96,83,83,96,99,457,457,500
88,80,96,83,95,442,442,500
88,86,91,90,90,445,445,500
95,92,82,98,98,465,465,500
81,81,90,85,93,430,430,500
99,81,80,83,85,428,428,500
96,83,91,90,95,455,455,500
83,96,84,84,80,427,427,500
88,95,82,85,87,437,437,500
85,99,90,92,90,456,456,500
81,88,81,95,86,431,431,500
81,99,89,98,84,451,451,500
80,85,92,82,99,438,438,500
95,92,93,91,92,463,463,500
80,97,89,84,87,437,437,500
87,88,91,90,89,445,445,500
89,98,96,83,89,455,455,500
84,89,96,89,94,452,452,500
99,98,97,82,95,471,471,500
96,97,80,97,83,453,453,500
89,86,86,82,92,435,435,500
94,81,84,96,80,435,435,500
96,97,82,82,82,439,439,500
98,86,81,98,97,460,460,500
83,99,94,81,92,449,449,500
86,97,84,89,93,449,449,500
80,94,98,85,83,440,440,500
89,80,83,87,86,425,425,500
81,94,91,85,92,443,443,500
83,92,87,87,99,448,448,500
88,86,84,98,96,452,452,500
98,90,94,84,98,464,464,500
94,88,85,97,88,452,452,500
92,89,80,81,80,422,422,500
88,80,82,91,84,425,425,500
82,95,97,88,80,442,442,500
80,81,94,87,94,436,436,500
93,96,87,83,89,448,448,500
88,93,96,85,82,444,444,500
88,90,98,98,91,465,465,500
91,90,94,96,90,461,461,500
92,82,88,99,88,449,449,500
91,92,87,98,84,452,452,500
83,94,98,98,83,456,456,500
93,98,93,97,80,461,461,500
91,94,88,80,96,449,449,500
81,81,90,81,81,414,414,500
80,96,85,82,86,429,429,500
91,80,93,95,84,443,443,500
90,92,83,93,91,449,449,500
94,86,93,96,99,468,468,500
90,84,93,86,99,452,452,500
85,99,83,88,87,442,442,500
81,82,80,82,83,408,408,500
81,92,98,96,81,448,448,500
95,86,85,82,82,430,430,500
80,98,87,85,89,439,439,500
83,81,87,91,85,427,427,500
85,80,84,81,80,410,410,500
93,87,88,89,88,445,445,500
95,84,83,87,84,433,433,500
87,99,95,88,83,452,452,500
80,99,96,98,92,465,465,500
90,87,98,82,86,443,443,500
84,87,92,92,84,439,439,500
85,90,93,83,89,440,440,500
80,93,92,80,81,426,426,500
94,88,81,97,95,455,455,500
99,88,87,95,91,460,460,500
94,86,92,96,95,463,463,500
90,96,91,89,90,456,456,500
98,95,85,94,93,465,465,500
91,81,97,83,92,444,444,500
87,82,97,86,84,436,436,500
93,93,86,81,88,441,441,500
92,92,80,85,80,429,429,500
89,80,88,96,99,452,452,500
81,92,97,89,87,446,446,500
93,96,89,92,90,460,460,500
99,81,94,91,98,463,463,500
91,89,96,85,90,451,451,500
97,95,91,93,85,461,461,500
80,88,93,82,91,434,434,500
83,85,87,99,84,438,438,500
83,89,96,99,96,463,463,500
81,95,94,80,96,446,446,500
90,81,93,97,84,445,445,500
88,83,86,99,89,445,445,500
91,93,98,97,94,473,473,500
85,83,87,93,80,428,428,500
97,84,87,82,93,443,443,500
96,80,92,85,88,441,441,500
82,93,96,88,93,452,452,500
98,82,84,84,96,444,444,500
89,94,89,94,82,448,448,500
80,93,91,97,95,456,456,500
94,91,87,81,93,446,446,500
97,83,93,96,86,455,455,500
91,89,92,91,83,446,446,500
82,85,80,96,95,438,438,500
91,80,96,93,80,440,440,500
82,80,99,86,86,433,433,500
86,92,92,97,99,466,466,500
83,84,81,96,92,436,436,500
82,84,92,90,85,433,433,500
99,90,90,91,92,462,462,500
96,86,93,90,91,456,456,500
85,82,97,97,95,456,456,500
86,95,87,90,91,449,449,500
99,87,88,99,89,462,462,500
95,84,99,94,93,465,465,500
84,96,83,87,81,431,431,500
88,95,89,97,97,466,466,500
85,89,86,81,91,432,432,500
82,97,85,85,85,434,434,500
97,81,91,94,81,444,444,500
94,88,94,90,97,463,463,500
81,98,84,90,81,434,434,500
90,83,87,88,83,431,431,500
92,85,97,99,92,465,465,500
92,81,90,91,97,451,451,500
89,85,91,97,82,444,444,500
91,93,91,82,95,452,452,500
86,92,99,98,92,467,467,500
95,90,92,87,82,446,446,500
94,87,86,95,83,445,445,500
88,95,94,87,83,447,447,500
94,93,93,87,93,460,460,500
89,99,88,85,91,452,452,500
80,82,83,94,99,438,438,500
80,94,93,91,84,442,442,500
90,89,94,98,84,455,455,500
90,96,81,99,92,458,458,500
91,87,93,93,82,446,446,500
91,85,89,88,92,445,445,500
87,92,80,91,85,435,435,500
89,94,92,92,88,455,455,500
99,84,88,97,85,453,453,500
85,90,97,97,85,454,454,500
83,94,85,91,82,435,435,500
97,83,97,95,81,453,453,500
86,96,99,94,92,467,467,500
97,96,93,95,80,461,461,500
82,93,85,93,89,442,442,500
81,80,89,82,94,426,426,500
87,92,91,82,96,448,448,500
80,88,97,92,82,439,439,500
96,98,99,84,80,457,457,500
81,81,83,97,86,428,428,500
86,83,97,84,83,433,433,500
96,87,95,95,82,455,455,500
81,90,90,83,91,435,435,500
96,80,93,86,98,453,453,500
92,85,99,83,89,448,448,500
91,88,92,92,89,452,452,500
94,90,80,88,87,439,439,500
93,82,81,92,95,443,443,500
89,91,98,95,81,454,454,500
99,89,81,96,97,462,462,500
87,81,85,85,96,434,434,500
90,98,87,91,90,456,456,500
91,95,81,95,81,443,443,500
91,99,94,97,94,475,475,500
80,99,94,82,87,442,442,500
85,98,92,89,84,448,448,500
97,99,85,97,85,463,463,500
89,82,87,81,90,429,429,500
93,93,99,84,89,458,458,500
93,83,97,98,93,464,464,500
96,85,93,87,85,446,446,500
98,80,84,81,95,438,438,500
92,85,95,86,93,451,451,500
95,97,97,80,92,461,461,500
82,93,91,95,86,447,447,500
89,88,90,83,91,441,441,500
82,90,92,83,85,432,432,500
98,99,88,82,99,466,466,500
82,86,83,81,86,418,418,500
84,93,84,82,83,426,426,500
85,92,99,82,86,444,444,500
81,84,89,93,81,428,428,500
84,94,85,85,98,446,446,500
86,94,81,97,89,447,447,500
88,84,96,95,86,449,449,500
99,99,96,87,97,478,478,500
94,97,82,84,89,446,446,500
80,91,89,83,91,434,434,500
92,95,82,90,80,439,439,500
87,88,87,94,97,453,453,500
94,91,84,88,89,446,446,500
80,80,83,93,97,433,433,500
95,87,92,90,87,451,451,500
86,95,84,94,89,448,448,500
87,80,88,92,94,441,441,500
94,85,89,81,80,429,429,500
84,96,80,90,94,444,444,500
96,98,92,87,81,454,454,500
92,89,97,99,96,473,473,500
92,88,82,97,89,448,448,500
86,81,99,86,84,436,436,500
80,96,83,84,94,437,437,500
90,81,93,80,82,426,426,500
98,89,91,80,96,454,454,500
90,84,88,89,87,438,438,500
81,80,97,81,94,433,433,500
93,93,84,95,93,458,458,500
80,94,87,87,81,429,429,500
84,97,96,90,87,454,454,500
84,92,99,94,89,458,458,500
89,86,84,97,85,441,441,500
91,96,98,81,98,464,464,500
87,82,97,97,95,458,458,500
98,89,85,93,81,446,446,500
98,85,86,80,84,433,433,500
91,85,98,94,83,451,451,500
88,86,85,83,92,434,434,500
87,93,93,99,82,454,454,500
87,82,95,89,97,450,450,500
99,86,83,99,83,450,450,500
85,84,81,81,90,421,421,500
97,91,87,81,97,453,453,500
84,92,96,97,82,451,451,500
98,83,91,81,86,439,439,500
89,94,98,96,82,459,459,500
82,82,84,87,95,430,430,500
80,84,94,92,82,432,432,500
91,99,90,87,90,457,457,500
89,87,93,84,81,434,434,500
90,83,82,90,93,438,438,500
83,82,96,85,86,432,432,500
93,94,86,93,89,455,455,500
92,81,93,96,90,452,452,500
90,80,95,84,97,446,446,500
95,98,81,88,91,453,453,500
88,94,88,92,94,456,456,500
89,86,97,93,81,446,446,500
95,85,96,82,87,445,445,500
80,88,91,97,83,439,439,500
94,99,84,85,84,446,446,500
91,86,83,98,93,451,451,500
89,89,83,83,80,424,424,500
90,80,92,87,85,434,434,500
81,89,91,82,97,440,440,500
81,83,82,99,92,437,437,500
81,95,84,84,98,442,442,500
93,87,89,91,81,441,441,500
86,85,91,84,86,432,432,500
80,96,85,82,99,442,442,500
86,80,92,85,90,433,433,500
93,80,98,90,89,450,450,500
89,94,84,93,93,453,453,500
93,90,89,97,92,461,461,500
81,82,97,93,82,435,435,500
90,99,97,88,85,459,459,500
97,82,80,85,80,424,424,500
85,91,82,83,96,437,437,500
90,87,93,94,87,451,451,500
89,99,85,85,83,441,441,500
86,94,96,88,89,453,453,500
84,80,98,99,87,448,448,500
87,87,89,95,84,442,442,500
99,80,99,85,92,455,455,500
80,99,93,93,83,448,448,500
96,86,91,88,92,453,453,500
95,94,92,84,87,452,452,500
85,99,97,80,95,456,456,500
81,80,88,87,97,433,433,500
94,99,93,93,97,476,476,500
87,97,96,80,86,446,446,500
93,86,90,90,85,444,444,500
88,80,84,82,84,418,418,500
96,82,98,92,83,451,451,500
81,85,95,83,84,428,428,500
93,85,85,89,86,438,438,500
88,91,99,96,88,462,462,500
83,86,88,94,96,447,447,500
91,89,81,84,95,440,440,500
99,90,95,86,84,454,454,500
95,91,83,87,88,444,444,500
80,96,80,98,96,450,450,500
89,83,97,93,88,450,450,500
85,82,89,81,86,423,423,500
80,88,85,84,94,431,431,500
80,88,83,90,97,438,438,500
86,86,88,80,81,421,421,500
91,91,89,80,85,436,436,500
89,92,88,86,97,452,452,500
86,95,80,81,82,424,424,500
93,87,95,86,95,456,456,500
90,81,88,97,81,437,437,500
98,93,82,88,97,458,458,500
89,94,98,96,96,473,473,500
90,87,88,96,81,442,442,500
86,88,88,81,86,429,429,500
85,91,92,91,96,455,455,500
94,93,87,99,80,453,453,500
83,91,92,99,84,449,449,500
93,96,87,98,90,464,464,500
93,87,93,91,91,455,455,500
92,89,93,88,97,459,459,500
97,94,89,82,95,457,457,500
83,82,85,81,84,415,415,500
80,95,96,86,85,442,442,500
89,99,83,99,80,450,450,500
84,87,82,80,93,426,426,500
95,84,97,95,80,451,451,500
80,85,80,95,99,439,439,500
92,85,96,98,87,458,458,500
85,86,98,89,95,453,453,500
86,88,91,84,80,429,429,500
82,82,84,89,91,428,428,500
94,82,95,81,97,449,449,500
90,88,80,84,81,423,423,500
87,82,94,99,92,454,454,500
99,91,97,88,96,471,471,500
90,83,91,99,93,456,456,500
98,83,83,83,83,430,430,500
93,89,81,94,87,444,444,500
99,97,97,99,87,479,479,500
92,86,87,97,84,446,446,500
87,80,84,86,86,423,423,500
80,97,80,85,81,423,423,500
82,97,94,91,92,456,456,500
92,90,96,97,92,467,467,500
90,88,95,92,88,453,453,500
81,96,87,93,91,448,448,500
83,84,96,85,92,440,440,500
92,87,97,86,94,456,456,500
86,96,88,87,93,450,450,500
81,82,85,95,88,431,431,500
87,86,95,87,93,448,448,500
94,84,91,87,84,440,440,500
98,96,93,83,81,451,451,500
80,90,88,81,82,421,421,500
92,99,84,98,86,459,459,500
89,88,88,93,94,452,452,500
93,89,98,88,87,455,455,500
87,89,91,99,93,459,459,500
89,90,87,84,80,430,430,500
98,96,81,87,81,443,443,500
99,90,88,86,90,453,453,500
85,95,93,99,92,464,464,500
98,80,97,90,81,446,446,500
93,90,98,92,92,465,465,500
98,89,92,95,84,458,458,500
84,89,94,86,95,448,448,500
95,84,85,87,80,431,431,500
99,91,84,99,80,453,453,500
95,97,84,92,82,450,450,500
88,83,96,86,88,441,441,500
85,96,98,85,87,451,451,500
97,89,98,97,94,475,475,500
90,80,80,85,88,423,423,500
90,85,86,89,94,444,444,500
88,85,82,83,85,423,423,500
88,91,93,94,91,457,457,500
90,90,93,83,96,452,452,500
96,99,85,88,80,448,448,500
92,83,83,89,99,446,446,500
91,87,94,90,92,454,454,500
81,82,85,90,96,434,434,500
95,99,97,89,87,467,467,500
98,99,89,92,81,459,459,500
87,98,82,97,91,455,455,500
91,96,99,98,84,468,468,500
89,94,87,95,80,445,445,500
85,86,90,91,99,451,451,500
85,85,88,80,89,427,427,500
90,95,82,82,86,435,435,500
97,86,90,90,93,456,456,500
83,81,86,85,96,431,431,500
94,80,87,99,85,445,445,500
96,95,90,80,87,448,448,500
85,81,85,91,93,435,435,500
82,97,87,96,88,450,450,500
82,84,88,82,97,433,433,500
91,98,93,94,86,462,462,500
92,98,89,81,93,453,453,500
88,95,87,90,80,440,440,500
86,93,95,83,94,451,451,500
90,87,92,97,89,455,455,500
93,98,94,94,82,461,461,500
92,95,92,88,83,450,450,500
96,93,90,92,90,461,461,500
86,84,91,94,87,442,442,500
93,88,91,88,98,458,458,500
96,86,88,87,97,454,454,500
88,99,98,91,96,472,472,500
80,83,84,80,90,417,417,500
98,95,84,87,93,457,457,500
84,96,80,98,89,447,447,500
96,92,89,97,99,473,473,500
87,93,94,94,97,465,465,500
85,84,95,90,97,451,451,500
96,88,95,86,85,450,450,500
92,89,90,84,96,451,451,500
89,83,88,84,88,432,432,500
99,90,94,96,92,471,471,500
91,89,95,85,81,441,441,500
93,82,85,91,87,438,438,500
99,84,88,85,95,451,451,500
91,94,95,88,89,457,457,500
95,80,84,84,97,440,440,500
88,88,88,96,95,455,455,500
95,98,98,91,85,467,467,500
99,91,96,99,91,476,476,500
90,99,87,90,92,458,458,500
83,98,97,81,98,457,457,500
89,91,89,93,83,445,445,500
88,90,80,80,81,419,419,500
95,93,84,89,96,457,457,500
91,81,92,94,97,455,455,500
95,96,99,97,89,476,476,500
82,91,82,90,94,439,439,500
96,85,97,97,93,468,468,500
93,82,80,97,82,434,434,500
86,82,98,91,83,440,440,500
97,94,80,96,92,459,459,500
86,85,95,82,81,429,429,500
98,93,86,87,82,446,446,500
80,93,85,99,86,443,443,500
88,96,90,92,93,459,459,500
94,95,93,82,92,456,456,500
92,81,97,81,83,434,434,500
88,80,97,83,97,445,445,500
94,99,96,96,81,466,466,500
94,95,98,82,84,453,453,500
84,82,89,85,92,432,432,500
95,98,82,81,81,437,437,500
83,96,90,81,90,440,440,500
88,87,90,80,85,430,430,500
95,91,88,84,96,454,454,500
81,89,82,96,89,437,437,500
97,92,87,98,85,459,459,500
85,91,93,99,83,451,451,500
95,95,82,88,99,459,459,500
93,86,82,93,88,442,442,500
82,81,89,85,83,420,420,500
84,96,98,82,83,443,443,500
86,83,85,80,96,430,430,500
84,90,96,99,95,464,464,500
94,86,83,95,90,448,448,500
82,86,90,85,91,434,434,500
93,97,89,88,93,460,460,500
88,84,91,91,80,434,434,500
92,91,94,94,97,468,468,500
82,88,97,90,80,437,437,500
93,89,97,96,89,464,464,500
95,80,91,82,87,435,435,500
97,80,98,95,90,460,460,500
87,94,87,82,90,440,440,500
93,95,89,85,83,445,445,500
95,82,86,90,91,444,444,500
89,81,80,97,90,437,437,500
89,94,98,90,98,469,469,500
83,89,90,87,80,429,429,500
97,97,83,81,94,452,452,500
87,90,90,94,96,457,457,500
88,82,98,95,88,451,451,500
87,92,88,82,96,445,445,500
87,86,93,93,81,440,440,500
95,92,81,84,92,444,444,500
93,98,98,81,83,453,453,500
88,90,91,99,82,450,450,500
82,83,95,92,82,434,434,500
93,80,97,98,85,453,453,500
98,99,96,92,91,476,476,500
85,99,93,82,88,447,447,500
91,81,91,91,99,453,453,500
91,98,86,99,90,464,464,500
97,91,92,92,90,462,462,500
87,82,88,93,80,430,430,500
95,82,93,81,97,448,448,500
96,93,90,89,83,451,451,500
82,98,92,86,87,445,445,500
83,93,93,87,88,444,444,500
80,90,91,94,87,442,442,500
92,90,93,93,97,465,465,500
99,84,95,84,84,446,446,500
98,80,96,91,94,459,459,500
91,81,85,84,98,439,439,500
91,81,86,85,96,439,439,500
90,95,92,93,97,467,467,500
81,90,83,91,88,433,433,500
97,82,90,87,90,446,446,500
91,96,89,83,86,445,445,500
89,89,85,87,99,449,449,500
92,94,97,80,99,462,462,500
96,92,92,98,82,460,460,500
86,98,92,82,85,443,443,500
87,93,84,94,89,447,447,500
82,81,97,86,90,436,436,500
82,85,95,90,83,435,435,500
90,94,82,96,81,443,443,500
84,81,86,97,90,438,438,500
91,94,85,89,98,457,457,500
98,96,83,96,97,470,470,500
94,86,96,89,89,454,454,500
87,81,90,95,94,447,447,500
93,82,88,99,87,449,449,500
93,92,93,88,91,457,457,500
82,98,89,87,83,439,439,500
91,99,84,93,88,455,455,500
87,86,92,90,99,454,454,500
97,86,90,89,93,455,455,500
84,91,87,84,83,429,429,500
88,92,91,99,94,464,464,500
89,80,87,85,85,426,426,500
90,86,80,84,85,425,425,500
97,89,96,96,97,475,475,500
87,87,94,97,96,461,461,500
94,98,95,96,99,482,482,500
83,89,89,99,95,455,455,500
95,99,98,97,82,471,471,500
81,82,88,96,95,442,442,500
99,97,86,80,89,451,451,500
83,98,92,94,92,459,459,500
99,94,80,87,94,454,454,500
80,93,90,97,89,449,449,500
87,83,87,90,97,444,444,500
89,84,81,99,96,449,449,500
95,87,94,80,95,451,451,500
97,83,84,88,82,434,434,500
94,91,82,87,96,450,450,500
94,81,86,90,87,438,438,500
96,97,81,90,92,456,456,500
92,80,94,91,91,448,448,500
83,94,84,87,99,447,447,500
88,95,89,84,89,445,445,500
90,87,98,88,86,449,449,500
89,85,80,86,93,433,433,500
86,83,96,81,84,430,430,500
91,80,86,81,84,422,422,500
94,81,92,88,81,436,436,500
83,91,92,95,92,453,453,500
88,83,88,87,81,427,427,500
80,99,95,95,80,449,449,500
86,86,89,91,92,444,444,500
84,97,94,85,88,448,448,500
93,95,94,94,92,468,468,500
86,83,87,87,92,435,435,500
81,86,93,86,93,439,439,500
93,92,86,87,89,447,447,500
99,96,96,90,98,479,479,500
92,84,89,81,94,440,440,500
98,86,91,86,99,460,460,500
84,99,83,85,80,431,431,500
97,91,89,81,81,439,439,500
99,80,85,84,91,439,439,500
85,99,98,95,95,472,472,500
93,88,85,81,88,435,435,500
85,97,85,83,86,436,436,500
94,80,98,95,97,464,464,500
92,99,84,81,81,437,437,500
91,82,94,98,80,445,445,500
85,90,91,88,96,450,450,500
96,87,95,97,92,467,467,500
88,91,89,99,96,463,463,500
81,80,83,86,88,418,418,500
81,83,95,85,83,427,427,500
97,95,98,95,87,472,472,500
82,83,92,86,93,436,436,500
95,83,88,91,90,447,447,500
80,88,84,98,99,449,449,500
88,90,91,91,91,451,451,500
97,96,99,92,97,481,481,500
81,88,98,90,89,446,446,500
89,93,83,86,96,447,447,500
94,84,87,87,93,445,445,500
93,96,86,84,94,453,453,500
90,86,81,91,95,443,443,500
83,95,91,95,94,458,458,500
98,86,87,97,92,460,460,500
81,84,89,81,96,431,431,500
98,84,88,92,85,447,447,500
88,88,87,96,90,449,449,500
82,87,97,98,83,447,447,500
80,83,93,95,93,444,444,500
94,82,88,85,99,448,448,500
93,97,90,98,88,466,466,500
82,98,93,91,84,448,448,500
83,88,91,97,93,452,452,500
99,89,83,88,83,442,442,500
85,81,80,84,96,426,426,500
82,86,93,93,82,436,436,500
83,88,83,97,98,449,449,500
93,97,95,80,94,459,459,500
82,81,93,91,83,430,430,500
97,91,88,91,82,449,449,500
86,87,92,97,88,450,450,500
83,94,90,86,80,433,433,500
94,98,95,91,95,473,473,500
81,87,86,95,87,436,436,500
92,85,94,83,85,439,439,500
93,99,89,98,82,461,461,500
95,94,90,96,90,465,465,500
97,91,80,83,84,435,435,500
87,88,87,96,84,442,442,500
91,81,95,86,99,452,452,500
91,95,81,87,80,434,434,500
90,97,96,83,97,463,463,500
99,89,80,88,93,449,449,500
90,96,99,87,94,466,466,500
99,98,99,87,85,468,468,500
86,96,91,82,88,443,443,500
92,88,89,85,93,447,447,500
95,84,91,84,86,440,440,500
85,80,84,82,92,423,423,500
97,95,83,91,86,452,452,500
82,81,98,90,89,440,440,500
95,95,86,96,81,453,453,500
88,94,89,93,84,448,448,500
96,83,86,90,96,451,451,500
84,93,97,86,86,446,446,500
88,84,82,89,83,426,426,500
86,83,98,97,88,452,452,500
98,88,89,88,82,445,445,500
97,99,97,91,81,465,465,500
96,92,96,98,81,463,463,500
84,93,99,91,83,450,450,500
97,84,90,80,85,436,436,500
92,87,92,85,86,442,442,500
82,82,91,87,93,435,435,500
85,91,82,85,90,433,433,500
89,90,92,89,99,459,459,500
99,85,81,90,84,439,439,500
99,89,84,96,86,454,454,500
95,98,82,96,94,465,465,500
86,94,92,94,84,450,450,500
91,96,88,90,83,448,448,500
93,82,95,94,92,456,456,500
90,98,83,80,81,432,432,500
80,87,93,99,91,450,450,500
97,93,88,83,84,445,445,500
85,96,81,86,95,443,443,500
93,99,94,86,94,466,466,500
84,95,84,97,97,457,457,500
93,88,86,92,82,441,441,500
99,97,87,96,96,475,475,500
84,81,80,94,95,434,434,500
95,81,97,80,86,439,439,500
86,91,85,88,86,436,436,500
95,82,83,97,84,441,441,500
96,99,86,89,91,461,461,500
90,95,87,80,94,446,446,500
92,98,87,92,94,463,463,500
83,98,96,81,97,455,455,500
85,97,98,93,85,458,458,500
86,92,99,83,96,456,456,500
80,86,93,89,95,443,443,500
95,99,98,83,86,461,461,500
97,82,92,96,92,459,459,500
81,95,87,81,81,425,425,500
88,86,91,85,98,448,448,500
92,95,97,81,98,463,463,500
85,96,86,98,94,459,459,500
86,95,84,97,92,454,454,500
81,91,90,94,97,453,453,500
95,91,90,88,97,461,461,500
83,80,86,96,81,426,426,500
88,88,86,96,80,438,438,500
88,83,85,95,94,445,445,500
90,88,98,86,85,447,447,500
82,80,81,87,86,416,416,500
94,86,90,90,90,450,450,500
96,86,87,87,82,438,438,500
92,85,80,98,97,452,452,500
86,81,87,98,82,434,434,500
87,89,96,96,99,467,467,500
84,89,82,90,91,436,436,500
80,89,87,95,81,432,432,500
83,81,90,97,89,440,440,500
94,94,94,86,93,461,461,500
87,82,81,83,98,431,431,500
98,80,80,86,99,443,443,500
80,93,81,91,99,444,444,500
95,91,81,95,87,449,449,500
82,81,81,96,88,428,428,500
82,94,94,88,80,438,438,500
98,80,88,97,88,451,451,500
95,90,98,92,91,466,466,500
82,91,92,81,85,431,431,500
92,88,98,94,81,453,453,500
97,97,88,92,84,458,458,500
96,92,98,99,99,484,484,500
84,92,85,87,83,431,431,500
84,92,93,86,91,446,446,500
81,86,81,88,98,434,434,500
84,90,99,93,90,456,456,500
83,96,97,81,91,448,448,500
90,99,92,96,98,475,475,500
82,99,99,94,87,461,461,500
98,91,82,85,80,436,436,500
87,98,92,92,85,454,454,500
84,88,92,96,98,458,458,500
82,92,97,87,99,457,457,500
86,87,81,82,96,432,432,500
92,89,86,94,98,459,459,500
93,87,97,93,91,461,461,500
83,89,93,82,97,444,444,500
91,85,90,98,96,460,460,500
85,91,83,85,90,434,434,500
97,83,88,89,96,453,453,500
88,93,93,80,82,436,436,500
89,88,84,81,85,427,427,500
91,96,92,96,99,474,474,500
88,88,95,98,81,450,450,500
81,85,89,91,84,430,430,500
88,90,88,97,94,457,457,500
84,80,91,80,94,429,429,500
99,85,90,81,87,442,442,500
98,86,99,80,83,446,446,500
83,98,82,89,81,433,433,500
92,88,98,98,81,457,457,500
85,87,84,94,81,431,431,500
90,94,98,99,84,465,465,500
93,87,92,98,83,453,453,500
80,82,98,99,92,451,451,500
85,88,83,85,90,431,431,500
97,81,95,87,91,451,451,500
87,97,85,80,98,447,447,500
80,99,88,91,95,453,453,500
90,96,88,98,80,452,452,500
92,94,98,85,97,466,466,500
99,82,87,90,97,455,455,500
80,99,92,80,86,437,437,500
88,84,83,95,87,437,437,500
81,98,87,94,91,451,451,500
92,95,95,93,91,466,466,500
95,94,92,87,94,462,462,500
80,84,91,90,82,427,427,500
93,96,80,89,87,445,445,500
86,93,91,80,96,446,446,500
98,95,97,81,99,470,470,500
81,97,92,82,82,434,434,500
98,85,93,85,86,447,447,500
80,92,90,81,84,427,427,500
86,85,81,96,83,431,431,500
90,92,80,84,93,439,439,500
90,98,96,99,95,478,478,500
94,89,96,86,82,447,447,500
81,98,84,88,81,432,432,500
86,95,85,80,95,441,441,500
99,82,83,98,91,453,453,500
98,82,84,90,99,453,453,500
88,98,80,93,85,444,444,500
90,98,86,97,82,453,453,500
84,99,89,98,91,461,461,500
95,86,97,99,85,462,462,500
97,91,95,87,92,462,462,500
87,96,80,80,80,423,423,500
93,91,85,95,92,456,456,500
93,87,86,90,81,437,437,500
84,91,92,90,87,444,444,500
91,85,92,81,87,436,436,500
88,90,86,98,82,444,444,500
82,99,91,84,98,454,454,500
83,99,94,91,98,465,465,500
83,86,80,93,83,425,425,500
86,80,99,84,92,441,441,500
90,99,82,84,89,444,444,500
93,91,94,91,96,465,465,500
92,87,87,88,98,452,452,500
81,97,97,97,89,461,461,500
88,84,81,84,83,420,420,500
95,91,89,99,99,473,473,500
98,80,90,95,92,455,455,500
91,88,86,96,82,443,443,500
82,81,97,85,83,428,428,500
98,90,85,81,84,438,438,500
87,81,82,88,99,437,437,500
87,97,80,84,90,438,438,500
89,92,87,97,86,451,451,500
89,85,90,88,82,434,434,500
94,99,93,99,99,484,484,500
86,97,91,81,85,440,440,500
84,82,97,87,99,449,449,500
84,81,81,89,90,425,425,500
93,90,92,95,83,453,453,500
95,89,92,96,82,454,454,500
86,82,80,97,88,433,433,500
92,98,81,85,82,438,438,500
97,96,90,80,94,457,457,500
92,91,84,86,83,436,436,500
81,87,87,83,92,430,430,500
80,89,98,87,80,434,434,500
91,83,92,95,91,452,452,500
87,92,89,89,96,453,453,500
86,95,86,96,92,455,455,500
87,98,94,97,85,461,461,500
97,89,88,93,83,450,450,500
81,80,98,86,91,436,436,500
80,86,95,84,80,425,425,500
91,87,81,87,98,444,444,500
81,83,94,98,85,441,441,500
94,89,99,80,86,448,448,500
81,90,85,90,84,430,430,500
93,94,82,92,93,454,454,500
95,84,97,92,83,451,451,500
92,83,91,91,81,438,438,500
93,91,86,90,86,446,446,500
89,85,83,96,99,452,452,500
85,83,84,97,98,447,447,500
85,87,97,94,91,454,454,500
85,93,96,95,87,456,456,500
86,96,95,89,90,456,456,500
88,99,99,85,82,453,453,500
89,86,82,95,94,446,446,500
82,87,96,85,94,444,444,500
96,82,87,93,85,443,443,500
98,86,93,91,85,453,453,500
92,92,97,89,90,460,460,500
98,96,98,82,93,467,467,500
96,80,91,98,86,451,451,500
89,84,98,95,87,453,453,500
85,86,92,91,98,452,452,500
89,91,98,80,99,457,457,500
87,93,97,87,85,449,449,500
91,81,90,99,84,445,445,500
94,83,83,95,80,435,435,500
95,96,82,80,87,440,440,500
97,93,95,90,97,472,472,500
87,81,93,95,82,438,438,500
90,82,83,84,86,425,425,500
83,88,90,90,81,432,432,500
87,92,87,86,96,448,448,500
93,82,94,99,99,467,467,500
95,83,89,95,99,461,461,500
88,95,94,92,98,467,467,500
86,84,89,99,91,449,449,500
94,97,81,80,99,451,451,500
98,85,94,94,98,469,469,500
97,84,91,92,81,445,445,500
82,98,91,98,86,455,455,500
95,94,88,90,88,455,455,500
92,88,82,99,96,457,457,500
85,85,92,86,98,446,446,500
98,85,96,89,81,449,449,500
81,85,99,93,82,440,440,500
83,81,85,86,83,418,418,500
85,85,89,81,99,439,439,500
89,90,89,84,90,442,442,500
95,90,99,88,87,459,459,500
90,99,95,83,96,463,463,500
99,89,91,93,97,469,469,500
80,85,95,81,84,425,425,500
86,99,90,98,82,455,455,500
95,88,84,83,97,447,447,500
99,90,80,94,80,443,443,500
91,82,87,98,80,438,438,500
90,95,97,87,82,451,451,500
89,99,94,93,94,469,469,500
97,81,99,92,90,459,459,500
98,80,96,97,92,463,463,500
98,90,92,81,93,454,454,500
83,97,88,83,92,443,443,500
89,87,94,94,89,453,453,500
87,98,92,99,93,469,469,500
96,86,86,92,98,458,458,500
85,87,95,89,89,445,445,500
93,84,86,96,94,453,453,500
98,90,94,84,95,461,461,500
86,86,95,97,87,451,451,500
82,97,97,80,93,449,449,500
94,96,94,85,84,453,453,500
83,99,86,85,97,450,450,500
88,93,94,89,80,444,444,500
92,94,87,92,85,450,450,500
91,86,82,81,81,421,421,500
94,83,81,91,87,436,436,500
81,95,89,94,80,439,439,500
91,89,81,82,82,425,425,500
83,97,98,89,82,449,449,500
82,80,96,95,82,435,435,500
94,80,90,82,94,440,440,500
87,95,89,90,90,451,451,500
93,90,93,91,82,449,449,500
87,94,91,90,95,457,457,500
91,85,89,84,90,439,439,500
99,97,96,80,84,456,456,500
84,80,88,88,86,426,426,500
81,81,97,92,84,435,435,500
97,81,83,80,87,428,428,500
97,98,94,94,91,474,474,500
90,95,92,98,90,465,465,500
92,96,97,80,96,461,461,500
83,85,81,95,85,429,429,500
93,93,84,93,98,461,461,500
90,91,89,96,85,451,451,500
85,81,98,88,84,436,436,500
91,95,88,80,81,435,435,500
84,84,98,85,89,440,440,500
82,83,87,99,94,445,445,500
97,91,81,81,95,445,445,500
94,85,84,98,84,445,445,500
82,90,95,86,93,446,446,500
88,90,85,88,89,440,440,500
93,95,95,91,82,456,456,500
97,84,93,93,98,465,465,500
81,97,84,86,81,429,429,500
82,88,88,80,97,435,435,500
93,84,81,85,80,423,423,500
91,98,94,95,83,461,461,500
81,99,93,90,83,446,446,500
80,94,97,81,83,435,435,500
90,97,83,94,88,452,452,500
84,92,83,87,86,432,432,500
92,85,93,97,82,449,449,500
93,97,90,80,82,442,442,500
93,81,94,87,92,447,447,500
89,85,85,93,98,450,450,500
88,85,99,92,97,461,461,500
88,94,85,99,83,449,449,500
99,90,81,90,97,457,457,500
88,84,99,99,93,463,463,500
98,80,90,91,82,441,441,500
84,83,88,83,98,436,436,500
88,89,81,84,91,433,433,500
96,82,88,82,90,438,438,500
93,83,88,98,89,451,451,500
86,81,97,93,92,449,449,500
91,89,85,84,80,429,429,500
87,99,95,82,86,449,449,500
89,97,85,98,86,455,455,500
89,92,84,82,98,445,445,500
99,88,96,90,87,460,460,500
82,89,84,87,89,431,431,500
93,89,97,99,89,467,467,500
84,86,82,85,90,427,427,500
98,81,82,97,91,449,449,500
90,90,92,98,86,456,456,500
81,97,98,83,94,453,453,500
87,94,95,90,83,449,449,500
96,94,93,98,88,469,469,500
98,82,97,99,82,458,458,500
96,86,97,86,93,458,458,500
88,87,90,91,95,451,451,500
97,97,93,82,93,462,462,500
86,95,89,96,98,464,464,500
97,91,82,80,87,437,437,500
89,94,86,81,86,436,436,500
87,94,98,80,91,450,450,500
91,93,86,82,90,442,442,500
99,98,90,99,94,480,480,500
92,89,90,88,90,449,449,500
91,88,80,92,95,446,446,500
87,81,88,84,81,421,421,500
98,96,88,86,92,460,460,500
85,82,87,99,82,435,435,500
93,88,95,82,99,457,457,500
82,91,82,96,86,437,437,500
98,95,92,93,96,474,474,500
88,91,89,85,83,436,436,500
90,94,83,87,81,435,435,500
81,84,95,90,84,434,434,500
90,80,84,90,87,431,431,500
80,83,86,84,92,425,425,500
93,87,92,84,91,447,447,500
91,96,82,94,84,447,447,500
98,93,85,86,82,444,444,500
82,82,84,82,93,423,423,500
80,87,85,92,86,430,430,500
91,87,89,93,87,447,447,500
80,90,88,98,91,447,447,500
85,95,82,81,99,442,442,500
92,99,96,85,96,468,468,500
96,91,80,90,82,439,439,500
80,98,83,87,99,447,447,500
98,82,90,84,88,442,442,500
89,97,82,93,83,444,444,500
81,88,88,95,91,443,443,500
86,93,97,89,95,460,460,500
93,85,87,97,86,448,448,500
86,96,86,85,86,439,439,500
81,93,92,89,81,436,436,500
96,88,93,92,99,468,468,500
97,88,91,92,98,466,466,500
84,88,84,97,91,444,444,500
87,92,94,98,91,462,462,500
83,90,94,89,85,441,441,500
96,91,80,93,94,454,454,500
82,91,86,87,96,442,442,500
91,97,89,93,85,455,455,500
97,91,83,98,95,464,464,500
96,80,89,99,90,454,454,500
86,89,84,86,96,441,441,500
83,84,93,92,83,435,435,500
92,93,99,85,82,451,451,500
96,92,90,96,92,466,466,500
83,94,85,87,98,447,447,500
86,88,90,94,93,451,451,500
92,84,96,87,84,443,443,500
95,80,84,86,90,435,435,500
81,83,82,93,88,427,427,500
96,98,98,81,91,464,464,500
96,95,85,87,94,457,457,500
90,95,92,91,98,466,466,500
84,91,80,98,96,449,449,500
80,92,88,96,80,436,436,500
93,84,89,80,81,427,427,500
80,92,80,88,90,430,430,500
84,96,91,99,88,458,458,500
80,89,87,88,80,424,424,500
87,95,87,89,98,456,456,500
83,83,92,90,91,439,439,500
91,83,92,88,80,434,434,500
95,99,90,85,86,455,455,500
83,99,94,88,88,452,452,500
95,90,98,94,98,475,475,500
84,86,95,92,85,442,442,500
85,89,91,96,88,449,449,500
93,88,86,99,94,460,460,500
94,97,82,86,96,455,455,500
85,95,90,91,80,441,441,500
90,87,94,88,94,453,453,500
90,94,91,85,89,449,449,500
96,90,94,98,87,465,465,500
83,91,84,98,84,440,440,500
99,80,99,94,85,457,457,500
96,82,95,91,91,455,455,500
87,91,87,80,83,428,428,500
86,82,98,90,87,443,443,500
95,80,93,98,93,459,459,500
93,94,85,85,90,447,447,500
97,96,84,83,88,448,448,500
86,99,87,90,80,442,442,500
91,87,90,87,98,453,453,500
93,83,80,87,80,423,423,500
93,93,89,98,97,470,470,500
85,87,94,91,86,443,443,500
81,99,94,87,98,459,459,500
94,84,87,82,83,430,430,500
86,80,85,81,91,423,423,500
95,90,91,91,82,449,449,500
81,87,82,84,90,424,424,500
90,99,86,83,91,449,449,500
81,83,91,86,90,431,431,500
89,91,89,97,87,453,453,500
87,89,82,86,86,430,430,500
85,92,82,99,93,451,451,500
82,91,87,80,95,435,435,500
91,92,80,99,94,456,456,500
99,97,80,81,82,439,439,500
96,99,98,85,82,460,460,500
99,95,82,95,89,460,460,500
89,98,91,87,85,450,450,500
82,86,85,93,89,435,435,500
83,86,81,84,93,427,427,500
86,86,89,92,80,433,433,500
87,94,99,81,97,458,458,500
89,84,92,82,95,442,442,500
80,98,94,89,87,448,448,500
98,96,80,89,84,447,447,500
95,97,85,83,94,454,454,500
90,87,96,98,82,453,453,500
94,84,83,83,86,430,430,500
86,97,97,98,87,465,465,500
87,96,86,88,83,440,440,500
93,85,87,87,84,436,436,500
96,88,90,80,94,448,448,500
96,85,85,82,93,441,441,500
81,88,95,96,88,448,448,500
87,91,82,88,92,440,440,500
85,84,91,85,86,431,431,500
89,83,97,87,89,445,445,500
84,81,85,89,94,433,433,500
99,85,92,82,83,441,441,500
92,86,97,84,84,443,443,500
88,90,91,99,81,449,449,500
97,91,89,93,84,454,454,500
95,96,87,81,98,457,457,500
89,96,99,96,88,468,468,500
94,85,85,87,90,441,441,500
89,86,97,92,89,453,453,500
90,91,88,95,86,450,450,500
91,92,80,84,89,436,436,500
81,92,90,96,85,444,444,500
90,84,84,80,95,433,433,500
97,90,82,88,81,438,438,500
82,96,89,96,90,453,453,500
93,91,92,86,92,454,454,500
95,93,96,85,86,455,455,500
88,84,89,81,92,434,434,500
90,84,95,99,95,463,463,500
82,82,90,91,93,438,438,500
92,97,80,81,84,434,434,500
88,82,84,97,93,444,444,500
96,97,93,86,85,457,457,500
84,87,93,84,93,441,441,500
97,95,90,93,96,471,471,500
81,85,91,94,80,431,431,500
97,82,88,84,89,440,440,500
83,96,95,91,90,455,455,500
98,82,99,93,90,462,462,500
93,80,95,93,88,449,449,500
95,97,90,92,97,471,471,500
89,88,80,87,82,426,426,500
80,83,88,99,96,446,446,500
88,83,83,96,90,440,440,500
81,84,90,90,84,429,429,500
92,90,95,95,86,458,458,500
92,82,86,88,96,444,444,500
97,87,82,80,96,442,442,500
81,94,85,87,94,441,441,500
83,98,83,90,87,441,441,500
80,99,89,87,80,435,435,500
95,83,87,98,85,448,448,500
90,89,88,90,99,456,456,500
98,86,82,82,93,441,441,500
87,82,90,85,97,441,441,500
94,80,83,90,98,445,445,500
99,91,95,91,84,460,460,500
94,87,95,83,94,453,453,500
95,88,90,90,86,449,449,500
97,89,92,84,99,461,461,500
99,87,82,87,84,439,439,500
90,96,92,96,95,469,469,500
82,93,93,80,98,446,446,500
95,92,94,95,83,459,459,500
86,87,85,90,88,436,436,500
92,81,91,87,83,434,434,500
88,80,86,87,80,421,421,500
98,82,98,87,91,456,456,500
92,99,87,80,85,443,443,500
81,87,93,94,83,438,438,500
94,92,93,83,94,456,456,500
80,99,92,94,85,450,450,500
85,83,99,99,81,447,447,500
86,82,83,96,88,435,435,500
89,99,86,85,98,457,457,500
95,87,91,95,86,454,454,500
86,97,85,94,92,454,454,500
89,90,99,81,93,452,452,500
91,83,91,84,95,444,444,500
89,84,93,93,85,444,444,500
80,91,88,92,91,442,442,500
89,93,85,98,84,449,449,500
99,80,83,88,86,436,436,500
81,97,92,84,96,450,450,500
87,93,83,84,95,442,442,500
98,82,98,80,88,446,446,500
85,90,96,99,84,454,454,500
97,89,92,85,84,447,447,500
82,89,98,80,98,447,447,500
99,87,83,84,88,441,441,500
86,87,88,88,97,446,446,500
98,91,93,95,85,462,462,500
99,96,87,92,80,454,454,500
86,89,99,92,81,447,447,500
80,91,98,91,98,458,458,500
84,93,81,88,97,443,443,500
88,86,98,84,88,444,444,500
99,80,99,87,84,449,449,500
92,84,89,82,90,437,437,500
85,87,88,99,85,444,444,500
91,89,95,85,91,451,451,500
96,94,85,85,80,440,440,500
95,82,91,88,80,436,436,500
89,97,91,92,80,449,449,500
83,99,90,90,99,461,461,500
93,92,94,83,80,442,442,500
94,91,96,99,96,476,476,500
96,87,84,98,85,450,450,500
92,92,92,97,91,464,464,500
85,89,92,84,95,445,445,500
83,97,87,80,90,437,437,500
82,99,96,88,81,446,446,500
86,85,94,87,94,446,446,500
93,82,94,95,85,449,449,500
92,95,97,93,97,474,474,500
96,93,83,93,84,449,449,500
98,80,80,93,80,431,431,500
95,87,92,97,91,462,462,500
94,81,89,85,81,430,430,500
94,83,89,81,89,436,436,500
88,81,90,82,99,440,440,500
91,90,99,83,83,446,446,500
87,88,93,96,82,446,446,500
93,83,90,90,80,436,436,500
89,88,92,84,95,448,448,500
82,86,83,81,97,429,429,500
94,97,90,86,90,457,457,500
96,83,84,84,81,428,428,500
92,92,87,93,82,446,446,500
82,92,98,80,80,432,432,500
96,83,95,85,92,451,451,500
85,99,97,99,88,468,468,500
88,93,90,97,93,461,461,500
90,90,82,94,89,445,445,500
80,82,83,99,93,437,437,500
87,93,86,99,93,458,458,500
99,80,88,93,84,444,444,500
98,98,83,87,90,456,456,500
94,88,82,92,93,449,449,500
83,84,83,80,83,413,413,500
84,85,98,96,96,459,459,500
83,80,99,82,97,441,441,500
90,82,84,82,98,436,436,500
95,81,82,92,94,444,444,500
82,93,96,86,95,452,452,500
93,86,85,87,88,439,439,500
96,96,91,96,80,459,459,500
93,84,82,86,84,429,429,500
92,97,88,99,89,465,465,500
99,94,89,82,92,456,456,500
85,89,92,83,99,448,448,500
90,88,94,86,96,454,454,500
87,92,93,86,94,452,452,500
87,95,83,87,84,436,436,500
96,89,88,87,86,446,446,500
89,90,97,85,97,458,458,500
80,91,92,92,86,441,441,500
99,87,98,83,81,448,448,500
81,97,97,90,93,458,458,500
84,95,99,89,86,453,453,500
89,83,84,83,91,430,430,500
87,93,81,88,84,433,433,500
96,81,86,89,95,447,447,500
93,99,96,93,95,476,476,500
88,87,90,98,86,449,449,500
82,99,82,87,82,432,432,500
99,87,83,90,88,447,447,500
84,96,84,86,88,438,438,500
90,81,98,85,86,440,440,500
96,98,94,95,94,477,477,500
99,83,86,98,84,450,450,500
88,90,93,81,89,441,441,500
87,94,81,92,95,449,449,500
91,90,89,96,86,452,452,500
91,85,84,92,93,445,445,500
80,98,95,88,97,458,458,500
81,98,82,95,83,439,439,500
99,90,98,91,82,460,460,500
96,92,98,95,80,461,461,500
98,90,98,94,97,477,477,500
98,95,94,98,91,476,476,500
83,93,85,92,94,447,447,500
82,97,91,81,97,448,448,500
99,82,87,96,93,457,457,500
97,81,87,85,93,443,443,500
89,94,95,93,90,461,461,500
88,99,83,94,93,457,457,500
87,87,80,88,99,441,441,500
88,84,88,83,95,438,438,500
93,97,98,89,88,465,465,500
93,86,84,93,91,447,447,500
85,92,93,91,86,447,447,500
96,94,91,88,84,453,453,500
83,94,81,85,91,434,434,500
89,80,85,90,83,427,427,500
82,86,99,92,82,441,441,500
99,90,85,88,95,457,457,500
99,94,90,85,83,451,451,500
96,99,86,93,89,463,463,500
86,84,98,85,86,439,439,500
88,85,87,98,84,442,442,500
97,89,89,88,96,459,459,500
85,92,98,95,94,464,464,500
96,85,86,80,87,434,434,500
91,83,99,86,82,441,441,500
86,92,84,85,81,428,428,500
92,80,91,88,82,433,433,500
89,81,81,97,87,435,435,500
88,90,87,97,80,442,442,500
94,82,97,95,91,459,459,500
94,86,88,89,84,441,441,500
87,88,99,84,89,447,447,500
92,93,96,91,85,457,457,500
93,97,90,83,95,458,458,500
91,88,99,87,82,447,447,500
80,87,84,87,99,437,437,500
88,97,86,98,80,449,449,500
88,94,80,88,96,446,446,500
80,86,86,85,99,436,436,500
81,97,96,83,82,439,439,500
85,92,92,84,93,446,446,500
81,92,92,83,89,437,437,500
97,94,97,83,98,469,469,500
90,99,80,85,94,448,448,500
99,97,93,94,81,464,464,500
81,94,88,88,93,444,444,500
99,89,97,83,90,458,458,500
95,83,83,96,81,438,438,500
98,80,91,86,99,454,454,500
99,81,81,82,93,436,436,500
87,96,97,98,87,465,465,500
98,93,89,87,99,466,466,500
82,92,98,85,99,456,456,500
87,84,93,96,97,457,457,500
86,91,99,82,80,438,438,500
84,88,90,82,96,440,440,500
92,97,91,81,80,441,441,500
91,92,95,86,89,453,453,500
95,87,98,85,82,447,447,500
86,88,98,86,83,441,441,500
81,96,86,81,84,428,428,500
98,80,80,91,84,433,433,500
91,92,81,80,82,426,426,500
84,86,86,80,98,434,434,500
84,86,88,80,91,429,429,500
90,87,88,93,95,453,453,500
90,93,88,98,92,461,461,500
80,92,88,99,82,441,441,500
89,85,86,88,94,442,442,500
85,81,92,90,82,430,430,500
81,93,82,80,88,424,424,500
91,80,85,81,82,419,419,500
92,95,82,92,92,453,453,500
95,82,82,91,98,448,448,500
83,82,96,95,91,447,447,500
99,83,84,94,93,453,453,500
88,85,98,97,93,461,461,500
97,82,89,83,93,444,444,500
99,91,91,83,92,456,456,500
80,98,88,84,83,433,433,500
97,92,98,84,80,451,451,500
85,82,83,80,82,412,412,500
93,82,81,93,84,433,433,500
85,99,93,85,86,448,448,500
85,84,84,93,86,432,432,500
83,90,91,86,95,445,445,500
82,99,92,94,93,460,460,500
93,88,95,95,85,456,456,500
88,83,96,82,99,448,448,500
84,90,93,80,88,435,435,500
91,91,90,80,98,450,450,500
95,86,89,86,91,447,447,500
92,97,99,81,89,458,458,500
85,97,81,97,82,442,442,500
90,84,80,92,98,444,444,500
92,83,99,80,92,446,446,500
87,99,84,85,99,454,454,500
91,97,95,82,85,450,450,500
89,95,88,90,96,458,458,500
84,94,81,88,87,434,434,500
81,85,93,90,98,447,447,500
94,96,81,98,97,466,466,500
95,85,93,83,87,443,443,500
89,84,88,82,85,428,428,500
86,87,82,89,86,430,430,500
97,99,81,81,94,452,452,500
94,87,99,87,88,455,455,500
97,88,86,95,96,462,462,500
94,80,91,89,80,434,434,500
92,90,92,82,97,453,453,500
87,95,82,86,97,447,447,500
87,93,88,84,84,436,436,500
95,91,84,87,80,437,437,500
84,94,81,86,87,432,432,500
95,97,85,86,84,447,447,500
96,85,91,90,84,446,446,500
94,90,93,86,88,451,451,500
81,99,88,97,98,463,463,500
84,84,97,88,99,452,452,500
94,89,97,96,80,456,456,500
98,93,93,91,87,462,462,500
95,83,91,84,91,444,444,500
83,84,81,95,81,424,424,500
90,89,87,82,94,442,442,500
86,92,92,96,96,462,462,500
94,85,95,96,84,454,454,500
92,96,81,81,93,443,443,500
93,86,87,83,96,445,445,500
97,84,81,81,95,438,438,500
83,89,95,90,99,456,456,500
97,97,83,91,87,455,455,500
89,91,98,98,98,474,474,500
98,93,85,95,85,456,456,500
87,92,92,85,88,444,444,500
92,85,87,91,87,442,442,500
81,91,96,93,91,452,452,500
91,84,90,92,88,445,445,500
80,89,89,94,86,438,438,500
93,80,97,84,95,449,449,500
85,97,82,86,83,433,433,500
95,97,80,86,90,448,448,500
82,88,90,85,85,430,430,500
90,87,94,85,94,450,450,500
90,91,90,91,88,450,450,500
81,98,88,87,96,450,450,500
86,93,90,86,86,441,441,500
82,95,80,98,83,438,438,500
82,99,80,80,86,427,427,500
99,87,96,81,88,451,451,500
91,86,98,80,85,440,440,500
84,94,91,80,91,440,440,500
83,87,86,87,93,436,436,500
84,93,80,88,92,437,437,500
95,96,99,81,85,456,456,500
84,82,82,92,88,428,428,500
94,88,84,87,97,450,450,500
82,95,84,84,82,427,427,500
99,97,93,99,86,474,474,500
88,80,90,98,82,438,438,500
88,89,83,91,90,441,441,500
82,96,99,85,83,445,445,500
83,99,83,95,93,453,453,500
99,99,89,85,88,460,460,500
85,88,99,93,87,452,452,500
96,83,99,89,84,451,451,500
99,95,93,85,94,466,466,500
87,93,81,82,92,435,435,500
89,93,93,93,90,458,458,500
86,92,98,88,81,445,445,500
86,97,95,80,85,443,443,500
83,99,81,96,92,451,451,500
93,81,96,81,84,435,435,500
87,95,97,92,96,467,467,500
85,82,87,96,83,433,433,500
84,82,89,80,87,422,422,500
94,84,86,98,98,460,460,500
83,97,94,96,97,467,467,500
84,98,91,83,89,445,445,500
90,89,88,87,88,442,442,500
96,93,83,83,84,439,439,500
90,98,92,80,81,441,441,500
81,92,89,91,97,450,450,500
80,96,94,86,88,444,444,500
84,88,97,83,91,443,443,500
97,92,84,97,92,462,462,500
91,91,89,86,85,442,442,500
87,89,80,89,93,438,438,500
84,93,98,94,98,467,467,500
86,91,81,99,85,442,442,500
94,82,83,82,87,428,428,500
98,99,95,97,99,488,488,500
81,87,87,80,83,418,418,500
89,84,90,87,89,439,439,500
94,92,90,99,88,463,463,500
86,87,81,88,96,438,438,500
91,98,92,89,95,465,465,500
90,91,82,91,96,450,450,500
80,85,89,99,99,452,452,500
91,85,97,82,88,443,443,500
85,93,81,92,92,443,443,500
84,80,95,99,89,447,447,500
94,91,81,89,93,448,448,500
85,88,87,93,96,449,449,500
93,85,88,93,86,445,445,500
90,91,86,87,96,450,450,500
90,91,99,91,99,470,470,500
99,85,99,90,90,463,463,500
95,81,80,95,81,432,432,500
91,90,93,84,82,440,440,500
81,87,86,83,97,434,434,500
93,95,85,87,93,453,453,500
87,95,90,87,83,442,442,500
94,95,82,97,81,449,449,500
97,99,92,84,99,471,471,500
91,87,98,99,89,464,464,500
98,86,93,94,99,470,470,500
84,89,98,98,87,456,456,500
98,88,95,97,95,473,473,500
89,92,90,87,89,447,447,500
88,93,99,81,81,442,442,500
95,96,88,98,90,467,467,500
96,82,89,90,84,441,441,500
88,80,95,80,92,435,435,500
94,91,80,95,85,445,445,500
85,89,84,91,94,443,443,500
80,84,92,90,92,438,438,500
88,93,98,97,80,456,456,500
97,97,95,84,84,457,457,500
94,96,95,80,87,452,452,500
96,97,88,90,80,451,451,500
80,87,86,98,99,450,450,500
97,80,90,86,84,437,437,500
87,85,93,84,97,446,446,500
99,99,93,99,94,484,484,500
94,91,97,86,85,453,453,500
99,96,91,80,83,449,449,500
82,87,94,93,97,453,453,500
88,96,94,84,84,446,446,500
97,92,86,93,81,449,449,500
95,95,80,94,90,454,454,500
87,91,81,85,95,439,439,500
92,81,90,83,81,427,427,500
88,85,97,97,82,449,449,500
98,89,96,81,87,451,451,500
98,81,84,94,82,439,439,500
81,83,95,85,88,432,432,500
86,90,87,96,95,454,454,500
90,93,91,86,93,453,453,500
87,91,98,99,83,458,458,500
95,89,83,89,82,438,438,500
87,95,88,80,91,441,441,500
89,92,83,82,92,438,438,500
86,94,93,91,83,447,447,500
85,82,88,97,83,435,435,500
83,94,88,92,84,441,441,500
80,98,89,83,87,437,437,500
95,82,93,90,98,458,458,500
99,99,97,87,90,472,472,500
95,88,86,81,89,439,439,500
94,93,90,91,87,455,455,500
94,80,86,97,96,453,453,500
88,85,91,88,91,443,443,500
93,92,87,95,92,459,459,500
84,91,80,89,83,427,427,500
98,82,88,87,81,436,436,500
88,94,87,82,95,446,446,500
86,84,82,99,91,442,442,500
87,80,97,93,96,453,453,500
83,89,84,97,93,446,446,500
82,94,87,89,84,436,436,500
84,91,99,82,90,446,446,500
99,90,84,96,89,458,458,500
98,82,88,80,80,428,428,500
80,89,87,96,95,447,447,500
98,91,88,85,95,457,457,500
84,98,95,95,94,466,466,500
80,85,94,95,85,439,439,500
98,96,97,80,86,457,457,500
90,95,82,99,82,448,448,500
99,89,96,99,89,472,472,500
86,85,80,93,80,424,424,500
91,91,91,99,92,464,464,500
87,84,96,98,98,463,463,500
85,88,89,82,97,441,441,500
83,80,99,97,86,445,445,500
85,85,84,83,81,418,418,500
84,91,89,85,89,438,438,500
83,92,87,89,93,444,444,500
89,80,87,94,85,435,435,500
84,80,98,88,84,434,434,500
91,93,89,94,86,453,453,500
83,90,88,95,95,451,451,500
84,85,83,86,91,429,429,500
97,91,97,85,89,459,459,500
90,91,91,88,84,444,444,500
92,97,80,89,81,439,439,500
97,93,93,91,95,469,469,500
97,85,88,81,86,437,437,500
85,85,90,88,97,445,445,500
86,83,92,92,99,452,452,500
89,86,81,85,90,431,431,500
82,81,96,99,84,442,442,500
87,84,96,85,94,446,446,500
82,97,92,80,80,431,431,500
83,84,89,81,95,432,432,500
84,84,93,96,98,455,455,500
80,92,88,84,88,432,432,500
93,91,94,96,87,461,461,500
83,95,98,87,97,460,460,500
83,97,89,92,86,447,447,500
97,85,80,84,88,434,434,500
84,98,97,85,88,452,452,500
97,89,84,80,83,433,433,500
97,89,86,95,94,461,461,500
87,89,97,95,95,463,463,500
99,99,86,85,81,450,450,500
93,81,82,82,85,423,423,500
85,92,94,87,92,450,450,500
92,98,96,90,81,457,457,500
81,85,83,83,97,429,429,500
88,85,87,94,88,442,442,500
93,81,85,93,91,443,443,500
95,85,85,89,89,443,443,500
85,97,97,87,82,448,448,500
97,82,80,83,88,430,430,500
95,94,95,87,96,467,467,500
89,81,98,91,89,448,448,500
95,85,94,92,99,465,465,500
81,99,93,87,89,449,449,500
86,81,92,93,90,442,442,500
97,98,97,90,95,477,477,500
85,96,83,95,81,440,440,500
89,93,99,91,88,460,460,500
82,95,97,89,94,457,457,500
97,86,93,95,89,460,460,500
95,80,84,84,80,423,423,500
89,92,88,88,86,443,443,500
93,83,82,90,99,447,447,500
90,86,85,88,87,436,436,500
81,98,98,89,86,452,452,500
85,91,99,83,99,457,457,500
86,93,96,81,98,454,454,500
90,93,80,87,98,448,448,500
88,94,96,90,96,464,464,500
84,92,80,95,85,436,436,500
99,83,92,82,82,438,438,500
92,89,88,85,91,445,445,500
98,97,97,93,88,473,473,500
89,95,85,83,92,444,444,500
96,80,89,80,83,428,428,500
88,86,86,83,98,441,441,500
93,87,97,85,90,452,452,500
90,91,98,83,95,457,457,500
94,80,89,80,98,441,441,500
96,92,83,90,84,445,445,500
87,88,97,80,98,450,450,500
80,91,97,88,85,441,441,500
98,86,83,81,93,441,441,500
87,88,92,99,93,459,459,500
96,99,85,83,99,462,462,500
89,97,87,85,95,453,453,500
93,81,88,95,89,446,446,500
89,92,91,90,97,459,459,500
98,99,80,85,89,451,451,500
94,99,88,93,96,470,470,500
93,99,90,95,95,472,472,500
80,82,88,82,89,421,421,500
96,99,86,81,98,460,460,500
80,97,85,85,82,429,429,500
94,97,95,98,90,474,474,500
80,83,95,99,98,455,455,500
95,91,85,80,96,447,447,500
93,83,92,88,89,445,445,500
90,95,95,90,95,465,465,500
82,93,98,98,87,458,458,500
80,91,95,96,94,456,456,500
92,99,88,84,84,447,447,500
89,81,88,92,94,444,444,500
85,81,84,92,89,431,431,500
91,99,82,87,81,440,440,500
88,94,89,92,94,457,457,500
81,87,95,82,97,442,442,500
89,81,81,84,96,431,431,500
80,93,94,90,82,439,439,500
97,81,95,95,90,458,458,500
82,81,86,80,94,423,423,500
92,80,80,86,92,430,430,500
96,98,82,93,94,463,463,500
80,86,89,95,95,445,445,500
99,95,87,85,95,461,461,500
81,90,99,86,91,447,447,500
95,92,84,80,98,449,449,500
87,90,95,92,88,452,452,500
92,98,89,86,92,457,457,500
98,94,98,94,97,481,481,500
95,86,86,85,86,438,438,500
83,93,84,85,83,428,428,500
89,90,94,95,99,467,467,500
94,81,90,99,94,458,458,500
80,98,80,83,90,431,431,500
96,97,88,85,83,449,449,500
93,96,90,91,83,453,453,500
83,94,93,98,83,451,451,500
98,87,87,87,87,446,446,500
96,92,84,99,87,458,458,500
98,97,83,97,90,465,465,500
84,98,89,81,98,450,450,500
93,92,80,94,87,446,446,500
96,98,90,92,93,469,469,500
80,81,98,95,83,437,437,500
99,94,92,99,81,465,465,500
97,90,85,95,80,447,447,500
80,84,88,89,83,424,424,500
80,99,96,95,87,457,457,500
93,81,91,86,87,438,438,500
94,87,93,98,99,471,471,500
92,93,87,96,98,466,466,500
91,82,91,82,87,433,433,500
84,85,98,88,80,435,435,500
94,91,91,86,80,442,442,500
83,82,91,91,82,429,429,500
93,91,95,88,90,457,457,500
94,91,91,95,88,459,459,500
90,90,99,86,81,446,446,500
80,87,90,92,99,448,448,500
81,89,91,98,84,443,443,500
80,96,84,87,86,433,433,500
90,84,93,80,87,434,434,500
86,92,89,90,86,443,443,500
98,99,92,89,87,465,465,500
80,93,96,91,86,446,446,500
89,96,99,94,87,465,465,500
87,98,81,85,97,448,448,500
83,88,85,82,86,424,424,500
95,81,92,99,83,450,450,500
93,90,93,98,86,460,460,500
89,85,95,95,80,444,444,500
96,90,97,90,83,456,456,500
98,92,85,98,80,453,453,500
96,85,85,83,84,433,433,500
82,99,87,84,89,441,441,500
97,89,90,89,82,447,447,500
86,83,91,93,86,439,439,500
95,92,80,94,99,460,460,500
80,95,91,91,84,441,441,500
88,95,84,90,85,442,442,500
87,90,85,91,82,435,435,500
98,89,92,93,91,463,463,500
98,82,87,83,93,443,443,500
93,82,85,91,91,442,442,500
92,86,82,90,82,432,432,500
80,90,92,97,96,455,455,500
86,87,81,97,83,434,434,500
93,81,97,81,87,439,439,500
91,86,94,89,93,453,453,500
89,86,84,98,90,447,447,500
98,82,94,81,99,454,454,500
80,99,83,90,89,441,441,500
98,92,86,91,80,447,447,500
86,89,81,94,94,444,444,500
91,90,83,96,87,447,447,500
99,94,91,83,95,462,462,500
91,82,83,91,95,442,442,500
88,87,80,90,90,435,435,500
92,90,91,88,93,454,454,500
91,97,95,98,95,476,476,500
88,87,89,80,90,434,434,500
90,84,93,95,86,448,448,500
85,84,89,89,82,429,429,500
97,85,84,93,85,444,444,500
95,96,96,86,94,467,467,500
89,80,86,91,88,434,434,500
97,87,95,85,86,450,450,500
86,86,86,88,97,443,443,500
80,88,93,94,89,444,444,500
99,88,95,96,99,477,477,500
91,83,91,96,90,451,451,500
92,80,88,97,95,452,452,500
85,85,91,90,83,434,434,500
94,99,95,96,95,479,479,500
95,91,91,80,91,448,448,500
80,90,89,83,92,434,434,500
92,83,84,86,98,443,443,500
81,95,95,92,80,443,443,500
88,96,89,99,90,462,462,500
88,85,95,86,86,440,440,500
87,90,88,81,96,442,442,500
90,86,99,84,81,440,440,500
90,98,99,86,95,468,468,500
94,90,96,80,81,441,441,500
82,86,97,91,84,440,440,500
80,85,99,93,91,448,448,500
85,86,93,97,84,445,445,500
91,94,90,87,97,459,459,500
94,80,95,92,98,459,459,500
90,97,85,90,89,451,451,500
95,98,89,94,86,462,462,500
91,91,91,85,88,446,446,500
87,99,83,87,91,447,447,500
92,91,90,83,97,453,453,500
98,90,95,94,82,459,459,500
99,96,92,89,95,471,471,500
86,80,98,89,99,452,452,500
90,80,93,89,81,433,433,500
94,81,85,98,81,439,439,500
80,91,88,92,99,450,450,500
97,92,89,99,92,469,469,500
80,91,85,89,88,433,433,500
82,80,81,83,92,418,418,500
99,92,90,98,93,472,472,500
98,92,84,86,81,441,441,500
89,89,87,83,89,437,437,500
85,91,83,88,80,427,427,500
95,97,83,89,98,462,462,500
95,88,80,99,89,451,451,500
81,95,93,95,86,450,450,500
93,92,95,87,87,454,454,500
88,80,93,87,97,445,445,500
98,92,86,88,92,456,456,500
96,81,86,91,95,449,449,500
89,91,91,98,91,460,460,500
92,93,90,93,99,467,467,500
93,95,91,99,92,470,470,500
83,84,84,83,92,426,426,500
96,80,81,97,85,439,439,500
99,84,89,81,86,439,439,500
94,93,85,82,97,451,451,500
96,96,82,82,84,440,440,500
89,93,83,95,94,454,454,500
94,94,82,85,80,435,435,500
96,89,99,88,99,471,471,500
89,96,81,94,88,448,448,500
88,94,94,97,83,456,456,500
86,95,98,91,86,456,456,500
90,87,97,90,82,446,446,500
85,80,95,87,93,440,440,500
83,90,85,83,83,424,424,500
97,94,99,97,98,485,485,500
82,84,89,86,81,422,422,500
96,89,93,89,89,456,456,500
89,89,94,87,82,441,441,500
91,85,98,88,83,445,445,500
92,91,92,80,80,435,435,500
99,86,92,85,90,452,452,500
92,96,99,90,87,464,464,500
93,97,95,87,84,456,456,500
88,99,81,89,98,455,455,500
87,85,96,87,89,444,444,500
84,95,99,90,85,453,453,500
94,97,84,86,89,450,450,500
86,96,88,95,94,459,459,500
85,92,84,99,82,442,442,500
99,95,87,84,89,454,454,500
86,80,84,98,81,429,429,500
85,83,96,88,82,434,434,500
87,85,99,93,85,449,449,500
96,84,83,95,81,439,439,500
87,95,80,96,88,446,446,500
86,86,90,86,96,444,444,500
81,81,96,95,98,451,451,500
87,84,89,97,87,444,444,500
85,80,97,83,92,437,437,500
97,95,98,82,92,464,464,500
80,84,89,85,98,436,436,500
95,85,83,81,92,436,436,500
85,85,98,96,97,461,461,500
83,96,99,95,83,456,456,500
90,99,86,86,97,458,458,500
96,91,88,94,93,462,462,500
91,90,82,94,98,455,455,500
96,80,93,98,89,456,456,500
85,97,83,97,95,457,457,500
81,82,82,94,86,425,425,500
86,86,97,82,84,435,435,500
91,84,84,96,96,451,451,500
88,86,85,80,84,423,423,500
82,81,98,95,81,437,437,500
85,95,90,83,90,443,443,500
84,89,95,95,86,449,449,500
97,82,96,96,85,456,456,500
99,86,92,97,95,469,469,500
85,89,93,97,85,449,449,500
84,81,80,80,92,417,417,500
87,82,83,94,89,435,435,500
83,98,86,84,85,436,436,500
81,86,82,96,84,429,429,500
92,93,86,91,81,443,443,500
96,93,88,80,99,456,456,500
86,86,85,85,99,441,441,500
89,82,92,84,88,435,435,500
88,80,85,80,92,425,425,500
92,91,80,96,91,450,450,500
90,90,88,99,91,458,458,500
96,83,95,89,90,453,453,500
89,94,83,83,92,441,441,500
86,97,92,80,86,441,441,500
92,96,97,96,84,465,465,500
92,81,90,84,95,442,442,500
94,83,80,96,99,452,452,500
90,95,99,99,83,466,466,500
87,98,89,83,99,456,456,500
94,86,91,91,87,449,449,500
92,87,83,86,91,439,439,500
96,81,80,99,85,441,441,500
86,92,82,83,91,434,434,500
80,80,86,98,83,427,427,500
81,89,91,88,85,434,434,500
91,92,82,89,98,452,452,500
85,97,81,85,91,439,439,500
95,97,99,92,84,467,467,500
85,83,95,95,89,447,447,500
90,92,85,84,92,443,443,500
95,83,85,92,99,454,454,500
90,95,87,93,89,454,454,500
99,81,87,95,97,459,459,500
97,87,93,84,99,460,460,500
95,93,97,97,83,465,465,500
95,80,85,92,89,441,441,500
99,93,98,97,81,468,468,500
83,99,94,93,99,468,468,500
82,91,92,82,96,443,443,500
90,86,85,89,91,441,441,500
89,89,88,89,86,441,441,500
80,93,80,82,80,415,415,500
88,81,85,85,96,435,435,500
85,82,82,88,80,417,417,500
87,95,85,92,97,456,456,500
80,92,94,82,90,438,438,500
97,80,80,96,98,451,451,500
85,93,92,81,85,436,436,500
98,97,95,86,88,464,464,500
80,93,86,89,82,430,430,500
87,90,87,82,81,427,427,500
80,89,81,83,83,416,416,500
87,97,82,80,87,433,433,500
91,98,82,89,94,454,454,500
92,94,80,90,89,445,445,500
84,89,82,89,87,431,431,500
94,91,80,91,81,437,437,500
89,97,90,94,84,454,454,500
80,91,97,91,80,439,439,500
81,80,95,81,96,433,433,500
88,97,87,88,81,441,441,500
87,80,83,82,96,428,428,500
88,90,90,87,93,448,448,500
80,91,96,94,87,448,448,500
91,92,98,94,98,473,473,500
95,93,80,86,82,436,436,500
88,95,87,84,97,451,451,500
80,98,84,90,91,443,443,500
83,82,87,81,92,425,425,500
97,83,81,90,91,442,442,500
81,82,80,88,96,427,427,500
98,86,92,87,92,455,455,500
89,88,95,81,86,439,439,500
96,81,90,80,98,445,445,500
84,95,84,84,94,441,441,500
95,93,90,95,89,462,462,500
98,96,96,87,86,463,463,500
87,81,92,95,98,453,453,500
85,93,84,82,92,436,436,500
91,92,91,93,99,466,466,500
80,87,97,82,84,430,430,500
99,82,97,81,84,443,443,500
94,87,96,89,90,456,456,500
98,84,84,94,87,447,447,500
92,92,94,80,94,452,452,500
82,89,95,89,87,442,442,500
96,87,94,91,90,458,458,500
86,92,97,87,99,461,461,500
83,86,90,99,85,443,443,500
90,81,82,90,98,441,441,500
87,94,87,81,80,429,429,500
87,92,93,98,92,462,462,500
97,89,98,93,92,469,469,500
80,91,91,83,89,434,434,500
81,83,94,86,82,426,426,500
85,92,96,98,83,454,454,500
99,81,91,88,90,449,449,500
83,93,98,96,96,466,466,500
85,97,80,94,99,455,455,500
87,84,97,83,86,437,437,500
81,88,87,96,90,442,442,500
93,92,86,99,98,468,468,500
88,90,94,86,89,447,447,500
93,98,80,95,83,449,449,500
93,80,81,85,95,434,434,500
91,82,87,98,83,441,441,500
98,81,85,85,97,446,446,500
94,97,94,92,89,466,466,500
88,82,91,89,80,430,430,500
94,94,80,98,83,449,449,500
82,85,83,95,99,444,444,500
99,97,97,95,96,484,484,500
82,97,82,96,87,444,444,500
93,97,96,82,95,463,463,500
92,89,82,89,82,434,434,500
84,93,92,80,87,436,436,500
86,94,89,99,89,457,457,500
86,97,80,86,93,442,442,500
98,90,92,85,96,461,461,500
95,82,92,82,86,437,437,500
85,99,91,87,85,447,447,500
92,83,97,89,88,449,449,500
91,97,92,92,97,469,469,500
81,96,83,88,81,429,429,500
86,92,91,81,88,438,438,500
89,97,87,87,95,455,455,500
96,85,87,84,97,449,449,500
98,84,81,99,81,443,443,500
97,88,96,95,95,471,471,500
93,81,84,99,93,450,450,500
87,99,86,81,90,443,443,500
84,90,93,89,86,442,442,500
93,98,86,80,83,440,440,500
98,81,92,85,98,454,454,500
90,87,84,95,90,446,446,500
87,99,91,82,86,445,445,500
93,90,92,93,87,455,455,500
87,93,83,85,89,437,437,500
82,94,96,80,92,444,444,500
88,91,90,80,80,429,429,500
92,93,88,97,92,462,462,500
87,93,81,86,92,439,439,500
97,90,98,81,89,455,455,500
84,89,92,87,92,444,444,500
93,90,84,88,81,436,436,500
81,82,89,97,88,437,437,500
92,89,80,87,83,431,431,500
84,94,91,82,81,432,432,500
81,87,93,83,80,424,424,500
84,91,84,96,96,451,451,500
83,93,87,94,83,440,440,500
80,92,98,85,89,444,444,500
94,81,86,89,93,443,443,500
96,86,85,90,83,440,440,500
99,82,83,91,87,442,442,500
85,97,98,87,86,453,453,500
89,84,80,81,90,424,424,500
98,90,99,80,97,464,464,500
84,87,85,85,96,437,437,500
91,87,88,89,84,439,439,500
99,90,96,85,87,457,457,500
91,86,86,83,80,426,426,500
92,81,93,92,93,451,451,500
92,84,90,96,80,442,442,500
82,86,84,97,93,442,442,500
99,89,90,89,91,458,458,500
95,90,91,97,88,461,461,500
96,99,93,83,80,451,451,500
88,88,97,83,90,446,446,500
82,80,86,91,88,427,427,500
98,94,96,86,97,471,471,500
80,80,85,92,84,421,421,500
93,85,95,83,92,448,448,500
99,89,86,97,98,469,469,500
84,95,92,82,95,448,448,500
85,84,88,86,88,431,431,500
98,86,81,87,88,440,440,500
92,91,89,95,91,458,458,500
89,95,89,95,93,461,461,500
87,80,99,99,96,461,461,500
85,91,92,99,92,459,459,500
91,90,99,82,99,461,461,500
96,99,82,94,99,470,470,500
96,99,80,84,91,450,450,500
85,80,92,95,87,439,439,500
96,93,86,95,89,459,459,500
87,80,92,86,82,427,427,500
94,83,88,95,90,450,450,500
92,99,81,99,93,464,464,500
97,82,87,91,98,455,455,500
94,88,89,87,87,445,445,500
93,84,80,87,84,428,428,500
83,92,92,83,98,448,448,500
85,96,82,95,92,450,450,500
98,81,87,85,97,448,448,500
92,98,97,99,99,485,485,500
83,86,87,92,95,443,443,500
99,87,97,98,84,465,465,500
81,85,96,86,91,439,439,500
91,88,98,85,90,452,452,500
92,94,84,80,90,440,440,500
88,97,99,98,87,469,469,500
86,93,97,87,88,451,451,500
96,90,90,91,93,460,460,500
92,83,80,91,83,429,429,500
98,95,88,90,94,465,465,500
87,86,93,98,91,455,455,500
87,97,98,96,80,458,458,500
86,83,95,87,81,432,432,500
91,92,80,90,96,449,449,500
84,93,83,89,97,446,446,500
97,83,86,95,90,451,451,500
88,90,98,81,88,445,445,500
93,90,90,90,86,449,449,500
99,81,83,96,81,440,440,500
91,87,84,86,88,436,436,500
93,92,97,93,81,456,456,500
90,92,85,85,89,441,441,500
93,82,86,95,82,438,438,500
94,85,96,93,94,462,462,500
83,98,95,81,91,448,448,500
85,95,81,80,85,426,426,500
87,86,86,82,88,429,429,500
86,92,89,96,90,453,453,500
90,84,86,85,90,435,435,500
93,95,93,81,84,446,446,500
92,98,94,90,88,462,462,500
86,97,87,83,94,447,447,500
83,94,91,80,83,431,431,500
84,81,87,82,99,433,433,500
85,97,80,86,92,440,440,500
98,83,96,94,95,466,466,500
82,94,99,97,91,463,463,500
90,97,88,81,98,454,454,500
80,99,93,80,80,432,432,500
84,98,88,89,96,455,455,500
82,90,90,97,80,439,439,500
85,98,99,96,98,476,476,500
87,95,99,82,91,454,454,500
92,95,84,80,99,450,450,500
96,94,97,80,94,461,461,500
85,90,92,98,88,453,453,500
89,97,80,98,89,453,453,500
87,89,90,93,84,443,443,500
91,88,91,87,93,450,450,500
98,83,98,85,82,446,446,500
92,80,98,80,90,440,440,500
91,99,96,85,82,453,453,500
86,98,86,83,93,446,446,500
92,87,96,85,89,449,449,500
97,92,97,93,97,476,476,500
93,94,83,92,88,450,450,500
87,84,84,93,86,434,434,500
80,95,95,82,84,436,436,500
84,97,82,90,84,437,437,500
89,86,86,80,81,422,422,500
98,82,81,85,95,441,441,500
85,84,80,84,90,423,423,500
90,95,80,83,92,440,440,500
99,83,98,85,98,463,463,500
80,88,92,96,94,450,450,500
92,98,95,95,99,479,479,500
97,83,93,87,99,459,459,500
98,82,87,80,94,441,441,500
87,94,91,95,99,466,466,500
80,92,95,95,91,453,453,500
94,80,98,90,87,449,449,500
88,84,97,89,80,438,438,500
84,87,93,86,94,444,444,500
82,97,85,92,87,443,443,500
84,89,82,95,90,440,440,500
81,83,84,93,81,422,422,500
99,90,96,96,98,479,479,500
95,96,89,85,98,463,463,500
98,86,97,87,83,451,451,500
90,94,97,92,97,470,470,500
89,91,93,95,83,451,451,500
99,88,95,90,82,454,454,500
87,82,84,90,91,434,434,500
80,83,80,94,80,417,417,500
87,91,94,83,95,450,450,500
84,91,92,94,88,449,449,500
80,85,86,95,90,436,436,500
80,89,86,91,80,426,426,500
88,82,92,93,94,449,449,500
98,84,88,92,98,460,460,500
90,89,80,82,80,421,421,500
85,91,89,81,99,445,445,500
89,86,93,97,80,445,445,500
87,91,85,92,94,449,449,500
81,96,89,96,95,457,457,500
93,95,84,87,82,441,441,500
99,84,99,86,95,463,463,500
95,87,90,92,87,451,451,500
91,96,81,95,92,455,455,500
90,99,98,91,94,472,472,500
81,92,91,82,90,436,436,500
81,93,86,91,92,443,443,500
81,97,93,84,82,437,437,500
88,87,85,91,91,442,442,500
87,96,99,83,95,460,460,500
80,96,81,92,91,440,440,500
95,80,82,92,91,440,440,500
95,87,91,94,97,464,464,500
87,82,84,83,86,422,422,500
97,90,93,99,91,470,470,500
80,86,83,88,89,426,426,500
85,82,99,98,84,448,448,500
91,95,95,94,81,456,456,500
95,96,88,91,98,468,468,500
83,90,97,94,80,444,444,500
96,90,98,94,92,470,470,500
93,85,99,84,97,458,458,500
84,95,93,85,80,437,437,500
97,85,84,88,89,443,443,500
82,92,86,95,87,442,442,500
94,90,87,85,93,449,449,500
85,80,80,99,84,428,428,500
80,84,87,86,85,422,422,500
94,86,94,93,85,452,452,500
81,95,91,96,93,456,456,500
98,86,89,96,95,464,464,500
82,97,80,88,89,436,436,500
92,92,92,89,95,460,460,500
83,96,84,83,91,437,437,500
99,98,91,94,96,478,478,500
80,94,90,90,85,439,439,500
82,93,86,87,94,442,442,500
95,83,86,82,98,444,444,500
91,87,84,95,80,437,437,500
86,88,97,86,92,449,449,500
93,89,95,94,81,452,452,500
89,99,95,87,89,459,459,500
84,92,81,81,80,418,418,500
89,97,85,92,86,449,449,500
85,90,91,92,83,441,441,500
91,92,98,87,96,464,464,500
88,89,88,86,98,449,449,500
85,82,99,86,96,448,448,500
98,80,88,98,94,458,458,500
84,91,95,96,89,455,455,500
84,94,89,99,97,463,463,500
91,86,83,96,85,441,441,500
88,93,99,82,99,461,461,500
97,92,91,80,91,451,451,500
97,94,87,96,90,464,464,500
99,81,89,89,91,449,449,500
95,92,83,87,92,449,449,500
92,82,87,98,98,457,457,500
93,85,98,94,81,451,451,500
88,97,95,81,97,458,458,500
92,96,96,80,80,444,444,500
83,87,92,95,80,437,437,500
97,94,83,84,95,453,453,500
93,84,86,88,83,434,434,500
90,99,96,89,99,473,473,500
83,97,87,83,98,448,448,500
88,95,92,91,83,449,449,500
99,98,80,97,84,458,458,500
89,84,87,93,80,433,433,500
85,86,81,81,94,427,427,500
95,99,90,91,91,466,466,500
93,89,88,93,93,456,456,500
84,80,94,88,99,445,445,500
97,89,89,85,88,448,448,500
85,88,90,83,98,444,444,500
87,92,87,97,97,460,460,500
90,89,84,94,97,454,454,500
94,97,95,97,81,464,464,500
82,81,90,86,95,434,434,500
85,99,97,87,81,449,449,500
85,92,93,98,93,461,461,500
89,84,92,84,83,432,432,500
93,83,81,85,88,430,430,500
97,88,91,92,93,461,461,500
96,80,95,85,90,446,446,500
96,95,98,94,93,476,476,500
94,87,82,95,90,448,448,500
87,95,95,89,99,465,465,500
80,95,82,88,97,442,442,500
94,98,95,92,89,468,468,500
89,80,84,94,97,444,444,500
87,88,82,88,90,435,435,500
97,85,91,80,93,446,446,500
93,98,85,99,87,462,462,500
99,88,88,83,83,441,441,500
82,94,84,88,88,436,436,500
80,91,81,97,97,446,446,500
80,91,95,89,92,447,447,500
89,88,92,86,96,451,451,500
93,81,92,84,83,433,433,500
97,90,90,94,99,470,470,500
82,92,82,90,87,433,433,500
93,82,96,84,81,436,436,500
90,95,81,84,86,436,436,500
84,83,84,90,81,422,422,500
84,91,95,82,86,438,438,500
84,82,83,99,92,440,440,500
80,84,82,86,93,425,425,500
88,97,94,86,95,460,460,500
97,82,90,98,89,456,456,500
97,82,95,96,99,469,469,500
93,99,81,91,90,454,454,500
92,85,81,80,96,434,434,500
88,97,80,97,92,454,454,500
85,96,85,97,94,457,457,500
83,91,95,97,95,461,461,500
95,84,97,82,97,455,455,500
81,96,92,83,87,439,439,500
93,81,83,95,89,441,441,500
87,81,95,87,90,440,440,500
86,81,90,89,94,440,440,500
99,82,89,95,99,464,464,500
95,80,97,82,89,443,443,500
89,97,92,81,80,439,439,500
90,96,97,87,99,469,469,500
89,85,86,86,99,445,445,500
85,91,87,88,97,448,448,500
95,99,81,92,83,450,450,500
96,85,95,92,99,467,467,500
84,83,85,83,97,432,432,500
87,98,93,80,82,440,440,500
93,97,97,90,89,466,466,500
84,95,90,95,97,461,461,500
88,89,83,88,85,433,433,500
95,80,95,90,86,446,446,500
85,97,82,94,83,441,441,500
90,99,98,83,89,459,459,500
89,92,83,94,82,440,440,500
99,85,87,98,82,451,451,500
80,85,87,86,98,436,436,500
81,82,98,98,96,455,455,500
81,97,83,92,99,452,452,500
95,81,97,80,91,444,444,500
82,80,90,85,89,426,426,500
80,88,87,98,97,450,450,500
84,89,83,99,98,453,453,500
92,91,86,82,91,442,442,500
84,93,99,85,90,451,451,500
93,87,96,92,80,448,448,500
81,89,90,97,86,443,443,500
82,80,94,80,90,426,426,500
86,98,94,95,94,467,467,500
91,98,83,93,83,448,448,500
97,96,81,88,98,460,460,500
80,82,95,83,93,433,433,500
82,93,81,85,89,430,430,500
98,80,91,95,99,463,463,500
84,89,80,82,95,430,430,500
95,82,84,86,81,428,428,500
91,86,88,91,98,454,454,500
83,86,93,86,82,430,430,500
80,91,91,93,81,436,436,500
96,85,83,85,95,444,444,500
91,80,86,89,82,428,428,500
91,90,81,86,91,439,439,500
93,85,93,83,83,437,437,500
93,98,94,80,95,460,460,500
94,81,97,87,99,458,458,500
92,99,91,85,84,451,451,500
90,85,93,93,85,446,446,500
86,83,83,95,95,442,442,500
98,84,85,87,87,441,441,500
82,99,95,94,84,454,454,500
80,91,95,87,80,433,433,500
95,80,98,95,88,456,456,500
94,92,84,87,99,456,456,500
86,92,90,83,85,436,436,500
96,98,81,87,98,460,460,500
94,84,88,97,94,457,457,500
92,97,95,89,82,455,455,500
83,91,85,97,99,455,455,500
96,95,86,87,90,454,454,500
89,90,82,87,84,432,432,500
93,92,92,90,89,456,456,500
92,87,86,82,91,438,438,500
84,89,90,87,84,434,434,500
89,97,90,84,94,454,454,500
92,97,95,92,83,459,459,500
83,80,90,93,85,431,431,500
92,89,96,80,82,439,439,500
87,86,98,84,82,437,437,500
81,88,94,83,97,443,443,500
90,95,89,91,89,454,454,500
99,82,88,82,80,431,431,500
85,90,82,91,99,447,447,500
89,95,90,93,87,454,454,500
89,84,91,89,80,433,433,500
82,94,88,94,91,449,449,500
87,96,92,85,98,458,458,500
89,94,89,96,85,453,453,500
90,94,88,91,95,458,458,500
94,80,82,99,92,447,447,500
84,88,91,88,85,436,436,500
82,98,93,82,93,448,448,500
84,96,97,83,81,441,441,500
97,89,92,93,87,458,458,500
87,85,91,84,88,435,435,500
99,99,84,89,96,467,467,500
92,87,80,92,98,449,449,500
84,86,82,86,96,434,434,500
99,92,91,98,98,478,478,500
85,88,88,82,93,436,436,500
92,99,94,91,96,472,472,500
90,90,94,94,86,454,454,500
87,95,90,93,84,449,449,500
91,91,81,90,86,439,439,500
95,94,95,83,81,448,448,500
97,83,94,86,97,457,457,500
92,80,88,83,83,426,426,500
86,80,91,87,82,426,426,500
95,84,93,90,97,459,459,500
97,91,90,83,88,449,449,500
88,83,86,92,89,438,438,500
89,99,80,98,84,450,450,500
95,81,99,85,89,449,449,500
93,93,99,95,89,469,469,500
89,99,95,86,98,467,467,500
98,99,82,85,95,459,459,500
88,93,81,89,90,441,441,500
88,88,98,95,90,459,459,500
94,94,93,83,90,454,454,500
90,82,88,80,91,431,431,500
81,93,89,87,80,430,430,500
95,88,82,90,83,438,438,500
83,81,84,98,85,431,431,500
92,83,83,86,87,431,431,500
84,99,93,86,93,455,455,500
97,89,98,98,90,472,472,500
96,94,91,89,91,461,461,500
84,80,97,98,81,440,440,500
84,84,82,93,88,431,431,500
80,87,83,84,98,432,432,500
96,99,97,86,94,472,472,500
96,90,92,94,94,466,466,500
90,93,92,82,88,445,445,500
86,99,91,88,95,459,459,500
94,96,83,97,95,465,465,500
91,94,90,80,81,436,436,500
90,96,90,95,91,462,462,500
88,87,82,80,90,427,427,500
94,81,88,80,88,431,431,500
91,84,89,84,93,441,441,500
80,81,82,93,90,426,426,500
95,87,86,98,88,454,454,500
82,96,85,80,95,438,438,500
95,89,90,88,86,448,448,500
83,97,96,84,92,452,452,500
98,89,87,98,97,469,469,500
81,94,91,91,90,447,447,500
91,87,92,94,85,449,449,500
88,98,94,80,91,451,451,500
88,91,98,99,80,456,456,500
82,95,99,84,97,457,457,500
81,96,84,90,81,432,432,500
96,95,91,82,93,457,457,500
81,80,90,88,97,436,436,500
94,94,81,84,95,448,448,500
92,88,80,91,87,438,438,500
81,93,93,84,95,446,446,500
85,90,85,91,89,440,440,500
86,88,98,83,99,454,454,500
85,95,93,83,87,443,443,500
84,83,94,95,93,449,449,500
88,86,92,96,87,449,449,500
81,80,82,95,92,430,430,500
87,90,99,96,90,462,462,500
83,81,95,85,87,431,431,500
92,96,85,80,84,437,437,500
93,98,82,83,96,452,452,500
93,96,97,89,86,461,461,500
98,92,80,90,97,457,457,500
85,98,90,82,90,445,445,500
86,83,92,95,83,439,439,500
93,99,85,81,91,449,449,500
96,86,82,99,83,446,446,500
86,90,99,92,89,456,456,500
84,97,99,81,97,458,458,500
88,87,80,91,97,443,443,500
80,87,83,90,86,426,426,500
90,80,86,81,99,436,436,500
82,96,91,98,81,448,448,500
96,91,81,88,94,450,450,500
94,82,86,95,94,451,451,500
82,99,95,94,98,468,468,500
86,95,92,86,90,449,449,500
98,83,85,98,85,449,449,500
92,93,85,97,88,455,455,500
93,84,91,86,84,438,438,500
88,86,88,89,84,435,435,500
98,81,93,90,95,457,457,500
80,95,85,91,91,442,442,500
85,86,82,80,88,421,421,500
87,97,95,93,89,461,461,500
86,96,99,87,93,461,461,500
94,99,93,92,89,467,467,500
95,93,96,89,82,455,455,500
81,80,97,94,80,432,432,500
91,85,97,80,88,441,441,500
80,86,85,83,97,431,431,500
87,86,95,96,87,451,451,500
92,85,96,93,90,456,456,500
83,95,83,88,95,444,444,500
82,84,94,85,93,438,438,500
81,92,91,96,86,446,446,500
98,83,84,91,89,445,445,500
94,82,87,81,89,433,433,500
95,82,85,86,85,433,433,500
84,92,84,86,89,435,435,500
80,84,90,80,95,429,429,500
80,89,94,89,90,442,442,500
98,96,81,84,94,453,453,500
87,84,83,89,95,438,438,500
88,90,91,97,96,462,462,500
99,81,96,88,95,459,459,500
96,85,98,92,80,451,451,500
83,96,91,92,96,458,458,500
93,90,80,90,86,439,439,500
86,92,94,84,94,450,450,500
86,83,85,92,87,433,433,500
96,83,95,90,96,460,460,500
83,84,87,81,94,429,429,500
91,87,89,91,85,443,443,500
87,93,80,81,91,432,432,500
84,99,82,92,97,454,454,500
82,99,83,87,88,439,439,500
81,89,84,91,99,444,444,500
90,93,92,81,91,447,447,500
86,83,81,91,97,438,438,500
80,98,84,93,80,435,435,500
84,97,96,86,99,462,462,500
91,82,98,94,80,445,445,500
90,83,86,88,82,429,429,500
98,87,86,94,99,464,464,500
95,89,85,81,86,436,436,500
82,89,90,85,99,445,445,500
84,94,81,97,94,450,450,500
96,86,84,97,92,455,455,500
83,98,92,99,95,467,467,500
99,94,94,81,94,462,462,500
96,83,90,91,89,449,449,500
87,98,87,87,99,458,458,500
88,88,83,93,90,442,442,500
93,86,93,82,93,447,447,500
83,99,95,91,80,448,448,500
95,95,85,95,97,467,467,500
86,95,87,96,90,454,454,500
88,94,88,98,87,455,455,500
82,96,97,81,94,450,450,500
92,89,96,90,90,457,457,500
92,88,92,81,80,433,433,500
82,96,99,84,83,444,444,500
92,93,97,88,84,454,454,500
99,95,80,94,80,448,448,500
96,98,90,85,99,468,468,500
96,81,81,91,91,440,440,500
99,96,95,89,87,466,466,500
88,94,98,99,99,478,478,500
83,86,90,97,91,447,447,500
97,93,84,84,83,441,441,500
80,97,84,91,96,448,448,500
89,94,80,98,81,442,442,500
87,86,92,89,90,444,444,500
99,87,89,88,97,460,460,500
82,80,80,94,88,424,424,500
88,88,95,82,86,439,439,500
98,92,81,99,82,452,452,500
81,82,92,93,80,428,428,500
98,80,83,92,84,437,437,500
94,98,98,80,99,469,469,500
84,87,87,98,82,438,438,500
81,91,86,97,91,446,446,500
94,92,91,96,88,461,461,500
94,95,81,97,94,461,461,500
93,94,94,95,98,474,474,500
94,89,94,90,81,448,448,500
98,92,97,87,88,462,462,500
97,85,89,85,83,439,439,500
86,89,95,87,98,455,455,500
98,88,94,81,80,441,441,500
92,80,81,88,91,432,432,500
89,87,82,97,95,450,450,500
90,98,91,90,90,459,459,500
98,91,93,88,99,469,469,500
89,81,84,92,85,431,431,500
88,87,92,83,83,433,433,500
85,88,89,82,88,432,432,500
81,81,83,81,89,415,415,500
81,94,80,86,82,423,423,500
91,99,96,94,84,464,464,500
83,81,85,94,98,441,441,500
94,96,86,85,92,453,453,500
85,90,82,96,82,435,435,500
98,82,98,99,80,457,457,500
86,96,89,96,97,464,464,500
84,97,94,93,82,450,450,500
80,98,84,89,98,449,449,500
92,82,81,96,93,444,444,500
85,81,85,83,86,420,420,500
89,94,89,98,96,466,466,500
82,92,93,85,97,449,449,500
91,99,89,92,83,454,454,500
92,99,91,80,99,461,461,500
98,92,96,84,85,455,455,500
96,98,84,88,80,446,446,500
91,92,86,98,90,457,457,500
96,82,96,92,80,446,446,500
97,89,89,87,83,445,445,500
93,84,97,87,82,443,443,500
81,96,96,84,84,441,441,500
80,97,97,88,99,461,461,500
90,87,82,85,91,435,435,500
98,95,92,96,93,474,474,500
94,92,90,87,93,456,456,500
97,91,81,80,96,445,445,500
95,80,86,87,87,435,435,500
94,87,90,87,84,442,442,500
85,84,94,87,86,436,436,500
97,87,86,95,99,464,464,500
99,90,95,98,95,477,477,500
90,95,87,86,98,456,456,500
97,91,90,95,98,471,471,500
99,92,92,86,95,464,464,500
82,98,94,84,95,453,453,500
90,89,81,98,95,453,453,500
83,97,89,85,94,448,448,500
84,84,92,89,91,440,440,500
94,93,97,94,83,461,461,500
86,89,95,82,97,449,449,500
82,99,89,99,81,450,450,500
91,85,83,95,89,443,443,500
95,83,91,97,85,451,451,500
97,99,82,94,95,467,467,500
81,97,94,83,87,442,442,500
81,94,98,92,89,454,454,500
92,86,91,99,93,461,461,500
92,87,85,84,96,444,444,500
86,96,94,91,90,457,457,500
87,87,95,80,95,444,444,500
97,84,98,91,90,460,460,500
90,99,96,95,85,465,465,500
83,84,86,95,96,444,444,500
86,94,96,89,80,445,445,500
82,98,91,83,93,447,447,500
95,95,83,83,93,449,449,500
87,83,85,92,87,434,434,500
93,95,95,97,99,479,479,500
96,95,83,85,89,448,448,500
91,93,81,83,96,444,444,500
93,87,89,80,92,441,441,500
90,93,86,80,86,435,435,500
91,91,82,87,93,444,444,500
94,90,87,85,93,449,449,500
86,80,98,90,82,436,436,500
97,89,80,83,93,442,442,500
98,98,82,84,84,446,446,500
90,94,88,84,87,443,443,500
83,82,83,96,87,431,431,500
86,90,93,99,94,462,462,500
84,88,80,84,89,425,425,500
92,98,93,88,96,467,467,500
81,83,86,87,86,423,423,500
99,84,84,87,81,435,435,500
85,92,98,99,98,472,472,500
85,86,83,88,80,422,422,500
96,94,99,81,86,456,456,500
89,82,80,81,93,425,425,500
84,82,80,80,89,415,415,500
94,80,80,81,90,425,425,500
97,89,98,87,85,456,456,500
94,81,81,89,95,440,440,500
93,92,90,83,82,440,440,500
94,81,90,86,87,438,438,500
87,82,93,83,93,438,438,500
83,93,96,99,89,460,460,500
84,81,94,85,93,437,437,500
80,89,85,82,82,418,418,500
87,96,87,80,81,431,431,500
80,83,95,80,86,424,424,500
98,81,93,82,97,451,451,500
83,86,83,88,92,432,432,500
95,96,80,90,86,447,447,500
81,96,88,81,86,432,432,500
95,90,86,93,82,446,446,500
87,84,92,96,91,450,450,500
85,82,95,83,83,428,428,500
93,93,80,92,81,439,439,500
80,93,92,88,94,447,447,500
99,98,97,80,83,457,457,500
93,88,94,92,96,463,463,500
88,91,99,85,83,446,446,500
95,83,93,82,91,444,444,500
87,99,83,93,94,456,456,500
98,93,89,88,87,455,455,500
98,95,83,92,90,458,458,500
85,83,97,98,96,459,459,500
87,88,86,86,95,442,442,500
90,94,81,96,91,452,452,500
95,83,84,95,87,444,444,500
91,96,86,83,88,444,444,500
93,99,93,84,99,468,468,500
83,92,81,96,86,438,438,500
95,88,94,85,84,446,446,500
88,90,89,88,85,440,440,500
97,96,88,93,85,459,459,500
94,90,86,99,82,451,451,500
82,95,94,91,81,443,443,500
90,90,92,93,96,461,461,500
92,94,97,95,92,470,470,500
96,99,96,92,87,470,470,500
90,95,92,94,88,459,459,500
80,81,95,94,89,439,439,500
93,82,88,91,87,441,441,500
96,95,86,81,81,439,439,500
90,86,87,91,94,448,448,500
97,96,87,99,80,459,459,500
83,98,93,93,90,457,457,500
80,81,93,97,87,438,438,500
86,97,93,93,94,463,463,500
95,97,94,96,99,481,481,500
91,80,97,98,90,456,456,500
97,94,80,82,92,445,445,500
91,94,83,95,80,443,443,500
88,87,82,89,97,443,443,500
82,94,97,86,82,441,441,500
81,88,99,87,90,445,445,500
97,93,84,87,88,449,449,500
80,83,81,99,80,423,423,500
92,93,97,95,80,457,457,500
83,98,95,99,98,473,473,500
97,82,98,83,95,455,455,500
95,93,81,97,97,463,463,500
84,96,93,85,90,448,448,500
93,84,97,82,95,451,451,500
91,92,85,94,80,442,442,500
92,80,91,86,98,447,447,500
83,87,87,86,86,429,429,500
80,83,97,93,95,448,448,500
81,99,91,86,85,442,442,500
90,99,92,82,95,458,458,500
91,99,83,86,81,440,440,500
98,85,96,85,86,450,450,500
92,91,84,92,94,453,453,500
94,93,97,81,97,462,462,500
96,90,88,89,87,450,450,500
96,98,97,89,90,470,470,500
89,94,98,94,82,457,457,500
96,97,88,80,81,442,442,500
91,94,93,82,83,443,443,500
83,85,86,93,93,440,440,500
80,86,92,86,83,427,427,500
84,97,90,85,81,437,437,500
93,98,81,81,94,447,447,500
93,99,81,85,95,453,453,500
82,99,98,91,82,452,452,500
90,87,94,88,94,453,453,500
89,92,82,92,99,454,454,500
81,90,82,94,87,434,434,500
85,80,87,90,98,440,440,500
88,97,84,97,90,456,456,500
96,83,97,85,93,454,454,500
82,90,94,98,82,446,446,500
81,80,86,87,83,417,417,500
81,91,99,85,95,451,451,500
87,84,88,82,98,439,439,500
89,88,87,86,93,443,443,500
94,96,91,85,91,457,457,500
83,82,92,98,87,442,442,500
83,94,85,94,97,453,453,500
99,81,88,85,93,446,446,500
87,89,98,91,92,457,457,500
90,80,98,94,82,444,444,500
97,97,82,96,92,464,464,500
96,88,89,87,91,451,451,500
97,85,95,96,95,468,468,500
87,80,83,84,98,432,432,500
99,87,83,90,88,447,447,500
88,86,97,91,89,451,451,500
97,88,85,99,91,460,460,500
85,85,96,96,93,455,455,500
85,93,90,97,84,449,449,500
97,82,83,81,92,435,435,500
84,82,85,91,81,423,423,500
97,96,89,92,86,460,460,500
88,84,92,97,81,442,442,500
90,81,86,81,86,424,424,500
95,98,82,83,83,441,441,500
94,99,87,94,88,462,462,500
93,88,90,91,83,445,445,500
94,81,94,95,88,452,452,500
85,90,88,91,95,449,449,500
96,86,85,89,89,445,445,500
87,82,83,80,84,416,416,500
82,84,92,83,86,427,427,500
99,99,86,98,88,470,470,500
92,88,86,81,87,434,434,500
91,92,96,96,85,460,460,500
86,83,91,91,87,438,438,500
99,89,99,93,87,467,467,500
92,85,86,86,88,437,437,500
88,84,94,86,93,445,445,500
99,82,81,90,87,439,439,500
81,91,88,87,96,443,443,500
85,87,80,80,89,421,421,500
91,90,93,81,99,454,454,500
92,86,97,93,85,453,453,500
94,80,80,92,90,436,436,500
88,92,81,99,81,441,441,500
81,96,95,82,81,435,435,500
93,94,99,91,94,471,471,500
84,92,81,99,83,439,439,500
85,97,92,81,84,439,439,500
85,88,88,82,95,438,438,500
88,84,94,80,88,434,434,500
83,84,88,80,89,424,424,500
98,90,84,98,81,451,451,500
87,82,87,83,96,435,435,500
85,80,97,82,91,435,435,500
88,86,96,93,82,445,445,500
94,87,88,86,96,451,451,500
88,97,91,97,93,466,466,500
96,89,82,85,89,441,441,500
84,89,97,81,84,435,435,500
93,99,89,95,88,464,464,500
87,84,95,96,81,443,443,500
94,82,81,92,89,438,438,500
82,90,84,84,98,438,438,500
83,94,84,94,98,453,453,500
92,99,96,85,99,471,471,500
91,91,81,95,83,441,441,500
80,99,89,99,89,456,456,500
80,81,83,99,94,437,437,500
92,88,90,84,89,443,443,500
97,82,99,92,94,464,464,500
82,80,98,83,82,425,425,500
92,93,95,97,81,458,458,500
97,97,94,98,90,476,476,500
85,81,84,81,89,420,420,500
84,96,95,95,94,464,464,500
80,98,90,95,86,449,449,500
95,95,94,83,80,447,447,500
84,81,81,80,96,422,422,500
98,80,88,95,88,449,449,500
95,88,90,90,86,449,449,500
97,99,96,89,89,470,470,500
97,99,81,92,81,450,450,500
97,91,81,86,87,442,442,500
99,94,98,83,91,465,465,500
92,87,97,94,91,461,461,500
86,94,87,83,87,437,437,500
98,93,89,80,87,447,447,500
86,93,97,82,85,443,443,500
98,99,82,88,84,451,451,500
82,85,88,91,92,438,438,500
88,85,92,85,98,448,448,500
90,93,95,94,90,462,462,500
85,96,97,88,82,448,448,500
89,89,84,98,88,448,448,500
92,80,88,87,90,437,437,500
92,86,80,80,84,422,422,500
86,89,82,92,96,445,445,500
90,80,85,85,84,424,424,500
99,81,85,94,92,451,451,500
92,91,85,91,99,458,458,500
81,93,84,81,89,428,428,500
81,98,89,84,86,438,438,500
93,97,93,87,86,456,456,500
86,89,82,81,80,418,418,500
90,98,96,93,85,462,462,500
84,99,90,97,91,461,461,500
99,87,89,80,80,435,435,500
97,83,92,83,88,443,443,500
81,99,81,90,90,441,441,500
82,83,85,80,92,422,422,500
91,84,90,96,82,443,443,500
86,96,82,84,90,438,438,500
92,81,87,84,97,441,441,500
91,88,96,93,83,451,451,500
96,88,85,90,84,443,443,500
86,98,97,90,89,460,460,500
82,86,85,80,83,416,416,500
92,98,95,96,92,473,473,500
83,83,80,93,94,433,433,500
85,97,82,80,93,437,437,500
97,89,84,81,82,433,433,500
87,90,96,90,87,450,450,500
80,83,98,97,80,438,438,500
95,91,99,96,92,473,473,500
84,97,98,96,81,456,456,500
90,91,90,96,98,465,465,500
91,90,96,86,99,462,462,500
99,86,94,93,84,456,456,500
96,91,97,80,82,446,446,500
84,96,83,82,92,437,437,500
95,97,97,88,93,470,470,500
81,87,83,92,81,424,424,500
83,94,98,99,99,473,473,500
97,88,94,91,92,462,462,500
85,83,84,99,80,431,431,500
80,80,87,99,99,445,445,500
81,87,81,83,84,416,416,500
91,91,96,89,86,453,453,500
83,81,98,84,83,429,429,500
83,92,89,99,81,444,444,500
92,90,85,82,95,444,444,500
94,87,97,87,95,460,460,500
99,93,98,94,89,473,473,500
95,84,93,87,91,450,450,500
88,84,81,96,98,447,447,500
88,93,93,95,94,463,463,500
95,81,97,99,89,461,461,500
80,84,81,90,83,418,418,500
92,82,93,93,93,453,453,500
89,94,95,90,90,458,458,500
88,83,90,90,81,432,432,500
95,99,81,93,80,448,448,500
83,90,99,94,93,459,459,500
98,82,93,93,90,456,456,500
80,82,83,91,94,430,430,500
82,88,95,96,93,454,454,500
92,81,98,92,80,443,443,500
84,91,99,82,82,438,438,500
92,93,98,86,93,462,462,500
82,92,94,82,90,440,440,500
95,96,88,97,84,460,460,500
84,94,96,87,80,441,441,500
98,98,87,96,80,459,459,500
93,91,80,84,87,435,435,500
94,98,86,81,87,446,446,500
95,95,99,85,92,466,466,500
93,89,94,90,85,451,451,500
99,86,89,91,84,449,449,500
83,86,97,80,86,432,432,500
80,96,94,91,81,442,442,500
83,88,89,90,82,432,432,500
94,80,89,95,95,453,453,500
80,89,90,91,92,442,442,500
87,88,99,86,94,454,454,500
93,89,88,98,93,461,461,500
87,98,91,82,89,447,447,500
80,88,91,90,97,446,446,500
91,96,85,81,80,433,433,500
97,85,91,95,94,462,462,500
92,99,81,83,84,439,439,500
89,86,81,96,84,436,436,500
90,83,96,92,81,442,442,500
82,81,82,93,87,425,425,500
96,92,80,93,91,452,452,500
85,82,82,81,92,422,422,500
83,91,95,80,93,442,442,500
85,94,98,83,86,446,446,500
84,94,98,97,90,463,463,500
85,82,96,93,85,441,441,500
88,92,92,88,80,440,440,500
91,97,99,92,91,470,470,500
91,92,96,90,96,465,465,500
80,88,80,86,97,431,431,500
93,90,98,86,82,449,449,500
95,81,90,97,84,447,447,500
81,94,81,92,92,440,440,500
91,80,97,99,90,457,457,500
96,80,89,94,98,457,457,500
80,96,93,82,88,439,439,500
95,90,82,97,91,455,455,500
82,88,87,99,96,452,452,500
91,83,99,81,97,451,451,500
99,91,99,83,98,470,470,500
86,95,93,80,86,440,440,500
95,94,97,93,96,475,475,500
95,96,88,83,85,447,447,500
84,88,88,83,84,427,427,500
95,82,85,93,84,439,439,500
87,92,82,91,80,432,432,500
97,91,80,95,99,462,462,500
84,86,96,80,80,426,426,500
98,85,92,85,92,452,452,500
86,92,87,83,82,430,430,500
85,80,98,92,94,449,449,500
95,94,98,99,96,482,482,500
89,88,93,81,88,439,439,500
82,89,82,81,93,427,427,500
83,98,90,93,86,450,450,500
91,96,90,95,93,465,465,500
80,80,93,93,90,436,436,500
97,98,82,80,94,451,451,500
85,92,96,94,92,459,459,500
81,83,83,93,92,432,432,500
85,98,96,93,96,468,468,500
80,82,84,96,90,432,432,500
83,97,84,88,96,448,448,500
98,95,99,97,92,481,481,500
99,89,98,98,94,478,478,500
86,92,80,97,99,454,454,500
92,86,92,93,95,458,458,500
89,85,92,86,88,440,440,500
87,93,99,98,91,468,468,500
99,90,90,91,96,466,466,500
99,82,83,81,97,442,442,500
84,82,91,86,92,435,435,500
97,91,80,96,98,462,462,500
96,82,85,91,85,439,439,500
89,90,89,92,88,448,448,500
88,93,87,90,87,445,445,500
85,96,88,92,92,453,453,500
89,86,95,81,85,436,436,500
89,91,98,81,92,451,451,500
87,85,90,98,94,454,454,500
87,90,90,81,80,428,428,500
82,98,86,86,98,450,450,500
92,87,94,83,87,443,443,500
83,93,93,83,85,437,437,500
98,98,87,90,90,463,463,500
89,95,92,87,98,461,461,500
88,89,90,85,97,449,449,500
88,83,80,94,98,443,443,500
87,85,99,90,82,443,443,500
98,84,99,93,92,466,466,500
90,80,93,85,89,437,437,500
84,93,82,91,98,448,448,500
96,92,81,87,92,448,448,500
91,89,84,87,82,433,433,500
92,82,83,84,93,434,434,500
84,83,95,80,98,440,440,500
87,98,86,86,94,451,451,500
80,89,99,90,95,453,453,500
99,80,93,82,90,444,444,500
99,86,92,93,99,469,469,500
86,80,83,93,86,428,428,500
86,91,96,87,88,448,448,500
81,81,95,84,90,431,431,500
80,96,91,89,91,447,447,500
96,98,98,83,95,470,470,500
88,90,91,91,95,455,455,500
95,91,83,96,96,461,461,500
99,95,86,82,80,442,442,500
82,82,80,97,98,439,439,500
80,82,87,84,87,420,420,500
93,84,91,93,84,445,445,500
97,83,88,98,97,463,463,500
96,85,84,95,90,450,450,500
81,94,83,87,83,428,428,500
94,94,88,84,89,449,449,500
88,95,91,95,89,458,458,500
80,83,81,96,92,432,432,500
96,92,98,91,84,461,461,500
84,97,99,95,89,464,464,500
80,81,87,88,84,420,420,500
93,82,99,91,99,464,464,500
86,98,85,82,86,437,437,500
92,88,95,88,91,454,454,500
81,81,82,91,92,427,427,500
97,91,90,85,99,462,462,500
83,83,94,93,80,433,433,500
97,85,83,83,96,444,444,500
80,88,96,87,83,434,434,500
89,88,81,86,93,437,437,500
88,84,85,83,93,433,433,500
99,84,86,92,82,443,443,500
90,85,85,90,83,433,433,500
86,84,95,88,97,450,450,500
97,81,83,91,91,443,443,500
83,87,98,95,99,462,462,500
80,82,81,93,84,420,420,500
81,89,88,98,99,455,455,500
94,92,95,90,89,460,460,500
94,81,89,85,89,438,438,500
98,80,80,96,93,447,447,500
91,85,89,94,89,448,448,500
80,97,87,88,92,444,444,500
88,85,84,91,90,438,438,500
94,90,86,95,81,446,446,500
84,88,94,92,93,451,451,500
98,82,91,85,96,452,452,500
89,97,93,96,84,459,459,500
94,97,96,86,90,463,463,500
86,92,86,82,89,435,435,500
92,94,98,84,86,454,454,500
84,99,89,84,99,455,455,500
88,86,97,86,98,455,455,500
96,85,93,93,88,455,455,500
83,85,83,88,80,419,419,500
89,97,95,88,97,466,466,500
97,90,87,96,95,465,465,500
91,81,86,88,84,430,430,500
96,93,88,88,88,453,453,500
86,94,98,82,82,442,442,500
97,88,90,95,91,461,461,500
85,93,97,80,85,440,440,500
80,90,91,97,84,442,442,500
89,85,87,96,89,446,446,500
95,91,93,94,98,471,471,500
85,87,85,80,81,418,418,500
94,82,92,85,92,445,445,500
96,98,99,82,93,468,468,500
86,81,87,83,89,426,426,500
86,95,99,80,95,455,455,500
82,84,98,87,92,443,443,500
91,88,87,97,88,451,451,500
88,81,80,84,87,420,420,500
86,80,90,94,93,443,443,500
98,93,84,84,81,440,440,500
89,96,98,89,85,457,457,500
81,94,81,91,97,444,444,500
99,88,81,94,86,448,448,500
96,93,92,80,83,444,444,500
90,83,94,81,90,438,438,500
89,80,84,85,99,437,437,500
96,81,85,99,92,453,453,500
96,91,94,85,88,454,454,500
93,81,98,83,92,447,447,500
90,92,94,84,87,447,447,500
98,90,85,86,94,453,453,500
82,98,88,96,81,445,445,500
99,90,99,88,98,474,474,500
95,99,92,96,99,481,481,500
96,83,92,86,93,450,450,500
82,96,98,90,95,461,461,500
90,94,93,92,88,457,457,500
93,82,81,87,92,435,435,500
90,91,84,90,96,451,451,500
83,90,95,80,88,436,436,500
95,85,86,82,87,435,435,500
92,97,94,98,85,466,466,500
88,92,92,97,88,457,457,500
82,88,88,86,98,442,442,500
96,93,84,87,92,452,452,500
99,83,91,94,95,462,462,500
99,86,85,90,86,446,446,500
96,81,96,97,96,466,466,500
80,93,86,82,87,428,428,500
81,82,93,84,87,427,427,500
82,93,84,98,90,447,447,500
85,81,82,86,88,422,422,500
99,80,95,97,89,460,460,500
96,80,86,88,94,444,444,500
92,96,95,87,98,468,468,500
81,89,80,99,84,433,433,500
89,95,91,91,98,464,464,500
90,87,96,89,97,459,459,500
98,88,88,88,83,445,445,500
99,92,90,99,98,478,478,500
95,94,97,93,88,467,467,500
86,80,86,91,87,430,430,500
95,88,82,96,98,459,459,500
88,94,82,89,90,443,443,500
90,96,89,93,89,457,457,500
85,84,88,90,94,441,441,500
82,83,87,86,89,427,427,500
96,97,86,94,94,467,467,500
98,84,90,95,92,459,459,500
97,94,93,94,97,475,475,500
97,89,89,86,91,452,452,500
99,97,97,93,85,471,471,500
82,84,92,84,83,425,425,500
93,95,80,82,98,448,448,500
93,93,96,87,98,467,467,500
90,85,91,86,96,448,448,500
94,80,93,88,92,447,447,500
96,93,80,84,96,449,449,500
89,86,83,93,98,449,449,500
85,82,98,85,84,434,434,500
90,90,86,91,93,450,450,500
95,83,89,97,84,448,448,500
95,97,81,98,87,458,458,500
86,88,95,98,92,459,459,500
90,80,85,81,81,417,417,500
97,96,91,84,95,463,463,500
83,94,91,99,83,450,450,500
98,95,81,83,86,443,443,500
97,95,80,88,97,457,457,500
88,89,98,86,87,448,448,500
92,93,88,87,80,440,440,500
99,99,93,85,84,460,460,500
81,87,93,98,89,448,448,500
83,90,80,82,84,419,419,500
85,94,91,98,96,464,464,500
94,83,88,92,82,439,439,500
90,83,82,87,80,422,422,500
92,92,83,89,99,455,455,500
92,91,83,99,94,459,459,500
94,90,98,91,88,461,461,500
88,80,83,85,87,423,423,500
86,91,95,98,83,453,453,500
98,99,83,86,89,455,455,500
96,97,83,88,80,444,444,500
81,85,84,80,86,416,416,500
91,85,98,97,80,451,451,500
94,80,99,81,80,434,434,500
89,84,82,85,91,431,431,500
94,87,82,85,98,446,446,500
97,86,98,96,80,457,457,500
84,82,87,91,80,424,424,500
86,90,89,95,84,444,444,500
81,81,84,92,84,422,422,500
93,90,92,83,87,445,445,500
95,89,93,85,96,458,458,500
85,95,89,93,95,457,457,500
88,81,85,83,98,435,435,500
88,95,86,85,80,434,434,500
91,98,93,98,98,478,478,500
90,94,89,89,93,455,455,500
80,99,96,87,84,446,446,500
80,82,88,92,85,427,427,500
97,92,85,92,85,451,451,500
88,94,90,91,87,450,450,500
95,95,92,92,85,459,459,500
98,92,85,99,83,457,457,500
80,91,96,95,95,457,457,500
88,85,86,96,92,447,447,500
90,86,94,98,85,453,453,500
81,98,82,93,91,445,445,500
87,83,81,98,97,446,446,500
85,98,87,95,80,445,445,500
91,93,88,99,85,456,456,500
99,80,92,88,95,454,454,500
99,97,97,92,92,477,477,500
89,84,92,85,97,447,447,500
83,89,87,98,92,449,449,500
98,93,94,92,86,463,463,500
95,80,97,98,99,469,469,500
90,96,81,97,82,446,446,500
95,95,96,99,92,477,477,500
99,93,89,99,90,470,470,500
87,88,92,96,98,461,461,500
90,86,96,83,96,451,451,500
85,92,86,94,85,442,442,500
83,85,87,97,99,451,451,500
80,94,99,93,89,455,455,500
87,89,89,89,84,438,438,500
81,87,87,97,88,440,440,500
99,90,91,90,99,469,469,500
98,99,84,93,82,456,456,500
88,89,99,82,89,447,447,500
80,91,92,97,97,457,457,500
84,83,85,97,85,434,434,500
81,96,89,95,84,445,445,500
86,80,93,88,88,435,435,500
83,87,88,95,84,437,437,500
98,98,91,99,80,466,466,500
98,99,84,94,86,461,461,500
96,95,90,90,87,458,458,500
85,95,98,91,91,460,460,500
83,98,86,96,87,450,450,500
80,93,80,87,87,427,427,500
84,84,83,82,92,425,425,500
87,82,80,92,84,425,425,500
99,90,98,84,91,462,462,500
93,87,89,86,89,444,444,500
87,90,90,97,97,461,461,500
98,85,92,87,98,460,460,500
94,83,94,80,88,439,439,500
90,89,81,84,97,441,441,500
83,99,95,82,83,442,442,500
81,82,99,95,94,451,451,500
90,89,87,95,86,447,447,500
92,82,94,80,83,431,431,500
89,87,83,96,95,450,450,500
95,90,81,96,95,457,457,500
85,96,86,81,95,443,443,500
80,90,92,97,85,444,444,500
93,87,99,85,83,447,447,500
96,84,84,82,98,444,444,500
92,90,92,88,87,449,449,500
90,99,84,94,82,449,449,500
99,95,85,84,97,460,460,500
83,94,91,97,87,452,452,500
92,95,99,89,99,474,474,500
99,88,83,82,84,436,436,500
97,92,99,89,84,461,461,500
81,87,80,88,90,426,426,500
96,80,87,81,93,437,437,500
91,99,81,96,85,452,452,500
87,92,87,98,81,445,445,500
87,96,99,84,88,454,454,500
94,96,88,92,87,457,457,500
94,88,88,93,91,454,454,500
83,81,92,88,98,442,442,500
89,98,98,96,81,462,462,500
92,83,99,91,80,445,445,500
85,87,87,80,94,433,433,500
80,97,96,98,92,463,463,500
88,82,99,87,88,444,444,500
85,87,81,84,90,427,427,500
99,97,93,96,80,465,465,500
88,81,87,98,98,452,452,500
90,98,94,88,94,464,464,500
84,82,98,92,98,454,454,500
83,95,94,87,96,455,455,500
97,83,88,90,96,454,454,500
93,97,89,87,83,449,449,500
83,98,88,93,87,449,449,500
98,82,81,85,83,429,429,500
90,97,96,83,83,449,449,500
91,97,99,81,81,449,449,500
98,95,92,90,83,458,458,500
84,94,89,92,80,439,439,500
96,94,80,90,98,458,458,500
90,90,80,95,80,435,435,500
89,97,99,97,82,464,464,500
89,80,96,98,81,444,444,500
83,87,92,91,98,451,451,500
90,94,86,85,88,443,443,500
87,93,95,90,95,460,460,500
81,83,88,87,90,429,429,500
94,80,84,85,91,434,434,500
80,95,97,95,85,452,452,500
98,92,95,90,98,473,473,500
81,94,98,95,99,467,467,500
80,90,95,95,96,456,456,500
98,96,88,85,94,461,461,500
81,89,85,91,81,427,427,500
98,83,87,84,87,439,439,500
82,80,87,99,81,429,429,500
96,81,97,82,91,447,447,500
87,92,89,95,94,457,457,500
86,87,83,98,98,452,452,500
87,88,85,83,97,440,440,500
90,84,84,90,90,438,438,500
90,95,93,94,94,466,466,500
87,84,86,95,99,451,451,500
98,92,90,88,96,464,464,500
87,89,95,93,81,445,445,500
92,91,90,95,82,450,450,500
85,89,83,80,95,432,432,500
86,85,87,83,89,430,430,500
85,81,93,99,91,449,449,500
82,89,84,98,82,435,435,500
91,99,84,83,80,437,437,500
87,82,97,82,87,435,435,500
96,92,95,81,88,452,452,500
97,92,84,90,82,445,445,500
95,89,93,82,96,455,455,500
84,97,83,84,87,435,435,500
83,94,90,92,94,453,453,500
88,85,82,80,86,421,421,500
83,86,83,87,81,420,420,500
83,97,85,92,82,439,439,500
81,83,85,93,80,422,422,500
90,87,96,95,98,466,466,500
85,98,86,94,88,451,451,500
99,85,83,88,91,446,446,500
84,93,88,97,82,444,444,500
92,91,84,96,99,462,462,500
86,98,92,91,96,463,463,500
97,84,85,96,94,456,456,500
87,87,92,83,88,437,437,500
98,85,84,80,95,442,442,500
86,81,92,96,91,446,446,500
96,84,91,81,84,436,436,500
97,81,91,86,95,450,450,500
98,92,86,85,97,458,458,500
91,90,82,82,82,427,427,500
94,83,99,90,89,455,455,500
82,83,83,89,98,435,435,500
90,99,94,87,98,468,468,500
84,83,82,89,82,420,420,500
82,82,95,84,97,440,440,500
81,88,89,83,95,436,436,500
81,95,84,99,95,454,454,500
89,94,93,91,94,461,461,500
95,83,93,95,94,460,460,500
83,93,96,88,90,450,450,500
81,85,87,83,82,418,418,500
96,92,87,80,88,443,443,500
96,97,84,82,96,455,455,500
82,81,99,89,87,438,438,500
93,98,93,80,92,456,456,500
83,95,99,87,93,457,457,500
85,85,82,82,88,422,422,500
87,82,84,95,99,447,447,500
99,87,82,91,86,445,445,500
84,90,80,93,96,443,443,500
97,88,93,99,86,463,463,500
80,86,90,87,85,428,428,500
81,92,86,95,86,440,440,500
82,99,86,91,83,441,441,500
97,91,99,80,84,451,451,500
87,80,88,82,93,430,430,500
85,82,87,97,84,435,435,500
91,91,91,99,99,471,471,500
96,99,84,98,87,464,464,500
80,94,83,85,88,430,430,500
81,93,99,80,98,451,451,500
97,83,95,95,91,461,461,500
81,98,95,83,81,438,438,500
84,81,81,94,99,439,439,500
88,92,96,86,80,442,442,500
97,82,88,81,95,443,443,500
99,83,91,92,95,460,460,500
97,91,95,87,92,462,462,500
99,82,98,82,89,450,450,500
98,89,80,82,83,432,432,500
82,86,83,99,85,435,435,500
98,86,80,99,80,443,443,500
88,81,83,82,82,416,416,500
80,90,87,84,80,421,421,500
84,81,90,84,95,434,434,500
94,95,91,87,99,466,466,500
80,93,96,95,90,454,454,500
80,88,94,95,91,448,448,500
80,97,90,98,83,448,448,500
84,86,92,87,87,436,436,500
97,90,92,85,92,456,456,500
96,86,82,96,90,450,450,500
96,94,86,99,93,468,468,500
97,84,95,89,90,455,455,500
99,84,84,83,96,446,446,500
93,83,97,97,94,464,464,500
84,80,96,92,96,448,448,500
85,83,86,84,99,437,437,500
80,82,85,96,81,424,424,500
90,93,98,92,86,459,459,500
86,83,98,82,99,448,448,500
91,94,81,97,98,461,461,500
80,88,95,94,96,453,453,500
85,84,99,82,80,430,430,500
97,88,80,89,80,434,434,500
91,89,94,86,83,443,443,500
84,90,98,97,97,466,466,500
94,84,98,80,99,455,455,500
82,81,89,88,89,429,429,500
81,87,94,90,92,444,444,500
90,87,92,91,81,441,441,500
92,91,81,93,99,456,456,500
92,93,89,86,95,455,455,500
85,93,98,99,82,457,457,500
98,82,89,86,99,454,454,500
95,97,90,89,86,457,457,500
95,94,99,98,88,474,474,500
92,96,99,98,80,465,465,500
82,93,83,82,83,423,423,500
82,95,80,87,85,429,429,500
84,86,80,95,85,430,430,500
95,80,94,96,99,464,464,500
80,87,90,95,87,439,439,500
97,91,93,92,88,461,461,500
86,84,94,92,82,438,438,500
86,86,92,87,83,434,434,500
94,93,93,91,96,467,467,500
96,87,82,87,90,442,442,500
83,87,87,98,89,444,444,500
89,93,96,82,93,453,453,500
84,85,88,90,91,438,438,500
97,89,82,83,80,431,431,500
96,85,96,98,82,457,457,500
88,89,81,86,95,439,439,500
84,82,93,81,95,435,435,500
82,83,94,93,82,434,434,500
85,90,80,83,80,418,418,500
99,94,84,93,83,453,453,500
99,93,99,92,96,479,479,500
88,80,84,87,82,421,421,500
83,90,83,91,80,427,427,500
88,81,93,94,95,451,451,500
88,96,94,87,92,457,457,500
92,84,87,97,81,441,441,500
81,82,92,85,83,423,423,500
97,83,80,97,84,441,441,500
80,93,97,85,87,442,442,500
89,94,82,89,97,451,451,500
99,85,94,96,92,466,466,500
99,90,87,91,83,450,450,500
88,90,81,84,86,429,429,500
97,89,84,85,92,447,447,500
96,95,81,96,91,459,459,500
93,85,90,88,92,448,448,500
95,86,95,95,81,452,452,500
90,81,88,81,89,429,429,500
84,88,97,92,92,453,453,500
94,92,94,87,89,456,456,500
88,80,88,81,98,435,435,500
82,90,81,83,95,431,431,500
99,88,85,99,93,464,464,500
97,95,99,95,97,483,483,500
81,93,92,99,90,455,455,500
94,96,93,89,96,468,468,500
98,84,84,89,81,436,436,500
86,96,91,99,89,461,461,500
82,89,88,88,88,435,435,500
87,96,88,99,99,469,469,500
91,91,82,88,85,437,437,500
86,90,86,93,85,440,440,500
99,91,89,93,85,457,457,500
80,95,81,93,82,431,431,500
82,91,85,89,87,434,434,500
93,96,89,99,92,469,469,500
97,86,90,90,84,447,447,500
82,96,84,86,98,446,446,500
87,80,91,94,92,444,444,500
91,85,80,92,81,429,429,500
89,82,93,88,96,448,448,500
99,87,96,95,85,462,462,500
98,98,85,90,87,458,458,500
89,92,94,86,96,457,457,500
81,93,86,94,82,436,436,500
86,96,84,99,99,464,464,500
98,83,83,90,84,438,438,500
86,88,84,90,80,428,428,500
84,81,92,84,85,426,426,500
88,93,91,85,87,444,444,500
95,92,83,84,90,444,444,500
88,83,94,89,91,445,445,500
91,95,99,95,99,479,479,500
88,94,95,96,98,471,471,500
98,85,97,80,89,449,449,500
88,81,99,90,98,456,456,500
83,90,95,92,80,440,440,500
86,85,88,94,84,437,437,500
96,94,92,81,82,445,445,500
96,84,80,96,99,455,455,500
82,89,86,97,88,442,442,500
98,81,87,94,84,444,444,500
84,84,92,87,80,427,427,500
97,93,90,80,95,455,455,500
95,82,97,97,83,454,454,500
86,86,96,87,98,453,453,500
84,85,82,95,81,427,427,500
91,83,98,94,99,465,465,500
87,87,88,98,94,454,454,500
87,98,87,84,88,444,444,500
87,91,90,87,95,450,450,500
99,80,82,91,94,446,446,500
96,92,93,96,87,464,464,500
98,87,85,86,87,443,443,500
92,89,90,87,97,455,455,500
95,90,93,93,97,468,468,500
80,93,96,96,80,445,445,500
97,99,96,92,80,464,464,500
84,87,86,86,95,438,438,500
99,88,83,91,94,455,455,500
90,82,80,85,84,421,421,500
85,93,82,82,81,423,423,500
87,82,97,93,82,441,441,500
93,80,85,89,89,436,436,500
89,93,88,94,91,455,455,500
83,86,86,97,88,440,440,500
99,96,82,93,89,459,459,500
85,92,95,95,92,459,459,500
99,88,98,90,80,455,455,500
88,97,94,80,99,458,458,500
82,92,82,95,99,450,450,500
85,98,86,91,82,442,442,500
84,82,93,95,85,439,439,500
88,95,87,93,87,450,450,500
91,81,80,93,95,440,440,500
80,84,98,94,82,438,438,500
93,80,85,88,99,445,445,500
84,84,82,92,92,434,434,500
97,83,99,99,96,474,474,500
81,92,86,89,92,440,440,500
90,94,89,96,87,456,456,500
84,83,85,99,90,441,441,500
90,89,81,92,96,448,448,500
83,89,81,87,96,436,436,500
86,96,90,81,98,451,451,500
80,84,86,94,96,440,440,500
87,99,88,91,96,461,461,500
88,98,82,91,99,458,458,500
87,94,87,96,86,450,450,500
86,88,83,88,89,434,434,500
88,85,92,87,81,433,433,500
92,80,92,93,83,440,440,500
85,98,85,93,82,443,443,500
85,96,96,87,80,444,444,500
84,93,94,96,85,452,452,500
87,85,97,80,97,446,446,500
82,84,86,87,83,422,422,500
81,84,98,93,87,443,443,500
91,86,88,90,92,447,447,500
80,88,99,87,80,434,434,500
85,81,97,97,81,441,441,500
95,86,90,96,84,451,451,500
86,83,93,80,88,430,430,500
96,99,82,84,95,456,456,500
94,98,98,93,93,476,476,500
95,85,94,99,96,469,469,500
96,94,98,83,99,470,470,500
90,96,91,98,98,473,473,500
80,98,91,87,98,454,454,500
90,88,86,98,99,461,461,500
87,91,94,87,92,451,451,500
95,93,98,83,91,460,460,500
81,91,94,93,80,439,439,500
83,87,98,98,97,463,463,500
86,97,97,87,83,450,450,500
97,88,99,91,90,465,465,500
85,81,91,89,94,440,440,500
99,88,93,85,83,448,448,500
83,94,90,90,91,448,448,500
90,81,87,94,98,450,450,500
97,96,90,86,93,462,462,500
91,80,97,88,90,446,446,500
80,84,86,90,86,426,426,500
91,85,93,95,92,456,456,500
98,97,84,98,88,465,465,500
81,94,86,96,91,448,448,500
88,97,93,93,92,463,463,500
83,96,89,96,89,453,453,500
85,84,87,82,91,429,429,500
98,80,83,83,98,442,442,500
89,94,83,81,94,441,441,500
96,98,81,84,80,439,439,500
99,82,81,82,91,435,435,500
98,87,93,95,81,454,454,500
87,91,81,98,97,454,454,500
92,96,84,87,84,443,443,500
94,86,93,96,94,463,463,500
97,89,89,92,80,447,447,500
95,88,86,82,99,450,450,500
83,96,86,96,89,450,450,500
93,91,85,95,88,452,452,500
91,85,86,90,98,450,450,500
83,81,87,83,97,431,431,500
83,84,87,86,80,420,420,500
87,80,98,85,84,434,434,500
98,81,85,95,99,458,458,500
82,96,94,83,81,436,436,500
83,97,88,82,80,430,430,500
82,91,81,95,94,443,443,500
91,92,98,91,81,453,453,500
82,91,91,90,97,451,451,500
91,92,92,94,97,466,466,500
99,88,84,92,93,456,456,500
96,97,83,85,84,445,445,500
84,89,90,86,98,447,447,500
83,86,93,92,94,448,448,500
93,82,88,91,86,440,440,500
84,94,99,83,83,443,443,500
80,95,86,80,86,427,427,500
89,93,93,99,85,459,459,500
89,85,94,83,88,439,439,500
90,85,93,88,92,448,448,500
99,87,94,86,86,452,452,500
90,95,99,89,92,465,465,500
95,93,91,84,83,446,446,500
92,87,85,99,83,446,446,500
83,92,87,80,94,436,436,500
89,97,96,88,85,455,455,500
87,83,91,92,82,435,435,500
86,92,81,98,97,454,454,500
96,94,81,90,92,453,453,500
90,85,81,84,88,428,428,500
82,96,85,82,83,428,428,500
85,94,92,96,90,457,457,500
86,89,97,96,85,453,453,500
93,83,85,81,86,428,428,500
96,90,89,96,86,457,457,500
85,99,95,81,98,458,458,500
84,96,81,81,94,436,436,500
85,97,93,96,94,465,465,500
95,89,94,94,81,453,453,500
87,94,92,81,90,444,444,500
94,95,83,81,92,445,445,500
82,88,82,95,90,437,437,500
87,88,89,88,81,433,433,500
94,88,80,90,94,446,446,500
89,97,94,96,86,462,462,500
99,93,84,86,99,461,461,500
98,90,84,94,84,450,450,500
95,89,88,91,84,447,447,500
90,84,84,85,99,442,442,500
90,84,87,99,86,446,446,500
87,82,94,90,90,443,443,500
82,84,99,91,96,452,452,500
92,94,80,85,85,436,436,500
96,90,98,90,91,465,465,500
85,80,81,88,81,415,415,500
91,95,99,82,91,458,458,500
87,87,81,98,99,452,452,500
94,83,85,86,98,446,446,500
85,91,97,90,98,461,461,500
98,92,96,93,94,473,473,500
99,98,97,80,94,468,468,500
98,84,94,99,87,462,462,500
96,99,86,93,80,454,454,500
91,85,89,95,95,455,455,500
99,88,96,82,83,448,448,500
86,81,97,88,90,442,442,500
81,90,99,95,89,454,454,500
88,99,84,98,89,458,458,500
82,83,99,90,97,451,451,500
99,86,91,82,86,444,444,500
83,96,94,90,80,443,443,500
87,80,92,88,92,439,439,500
96,84,94,94,91,459,459,500
95,96,85,97,83,456,456,500
93,85,98,82,86,444,444,500
97,96,96,93,86,468,468,500
81,86,93,83,93,436,436,500
94,83,87,82,93,439,439,500
95,95,91,90,99,470,470,500
85,99,82,98,89,453,453,500
83,80,98,91,92,444,444,500
80,90,97,92,94,453,453,500
86,81,80,93,98,438,438,500
94,92,80,82,93,441,441,500
99,90,89,87,87,452,452,500
86,98,81,95,93,453,453,500
92,85,89,89,86,441,441,500
84,90,82,96,91,443,443,500
97,95,84,84,91,451,451,500
92,82,98,81,99,452,452,500
90,86,82,81,86,425,425,500
91,85,88,94,80,438,438,500
85,90,97,98,92,462,462,500
95,97,98,96,96,482,482,500
97,82,86,95,94,454,454,500
94,97,90,88,97,466,466,500
83,89,94,86,94,446,446,500
94,95,80,81,81,431,431,500
99,97,94,95,88,473,473,500
98,83,94,90,84,449,449,500
88,87,83,92,98,448,448,500
87,93,95,86,90,451,451,500
81,94,94,94,88,451,451,500
83,86,99,80,90,438,438,500
98,82,85,85,92,442,442,500
95,86,95,83,80,439,439,500
93,91,84,82,84,434,434,500
87,99,81,80,91,438,438,500
97,92,90,98,88,465,465,500
89,84,92,91,82,438,438,500
96,98,84,82,91,451,451,500
87,90,99,86,86,448,448,500
95,85,89,88,88,445,445,500
83,99,90,90,85,447,447,500
99,88,98,88,99,472,472,500
85,83,88,92,97,445,445,500
87,90,93,99,88,457,457,500
90,87,97,82,97,453,453,500
82,87,83,96,98,446,446,500
80,85,95,88,89,437,437,500
85,82,97,85,98,447,447,500
87,87,84,98,83,439,439,500
92,88,84,81,92,437,437,500
94,93,87,82,85,441,441,500
99,87,86,92,99,463,463,500
89,82,81,83,85,420,420,500
85,86,97,98,97,463,463,500
91,97,90,97,87,462,462,500
89,83,98,94,94,458,458,500
99,80,95,93,99,466,466,500
93,90,95,89,81,448,448,500
96,82,81,96,99,454,454,500
86,94,89,98,87,454,454,500
86,88,85,87,95,441,441,500
90,86,85,94,96,451,451,500
82,88,82,89,87,428,428,500
98,88,83,94,94,457,457,500
82,88,85,84,83,422,422,500
81,81,84,82,92,420,420,500
84,87,84,94,88,437,437,500
94,90,95,86,90,455,455,500
88,87,87,94,84,440,440,500
87,96,82,88,99,452,452,500
81,80,82,84,83,410,410,500
86,84,90,98,85,443,443,500
82,99,97,85,80,443,443,500
94,94,81,97,93,459,459,500
97,97,82,96,87,459,459,500
89,96,91,96,96,468,468,500
93,96,98,80,88,455,455,500
81,82,81,94,82,420,420,500
82,80,88,89,86,425,425,500
88,89,86,81,91,435,435,500
96,94,86,92,91,459,459,500
94,86,92,82,91,445,445,500
81,99,82,88,81,431,431,500
97,94,87,87,92,457,457,500
92,87,90,92,99,460,460,500
82,96,90,85,82,435,435,500
86,82,99,91,95,453,453,500
86,80,95,92,83,436,436,500
97,89,89,93,93,461,461,500
94,97,89,84,98,462,462,500
85,90,86,94,83,438,438,500
89,86,86,99,93,453,453,500
80,88,97,87,99,451,451,500
83,83,89,80,86,421,421,500
85,90,89,96,83,443,443,500
86,87,80,97,92,442,442,500
98,87,83,95,96,459,459,500
88,91,82,94,92,447,447,500
83,95,98,98,93,467,467,500
86,91,93,84,99,453,453,500
84,85,95,94,90,448,448,500
92,83,82,99,87,443,443,500
80,89,98,85,92,444,444,500
91,99,89,87,86,452,452,500
94,88,91,90,99,462,462,500
83,80,81,97,97,438,438,500
86,95,96,80,93,450,450,500
97,90,97,88,91,463,463,500
89,88,99,92,96,464,464,500
95,94,82,83,91,445,445,500
95,82,88,96,86,447,447,500
89,96,92,80,86,443,443,500
86,93,98,93,81,451,451,500
85,99,83,87,84,438,438,500
85,86,89,81,83,424,424,500
95,86,81,92,99,453,453,500
94,93,92,88,84,451,451,500
96,92,91,98,86,463,463,500
88,88,94,82,86,438,438,500
82,94,89,98,91,454,454,500
99,83,91,86,99,458,458,500
99,82,91,88,99,459,459,500
88,86,95,94,83,446,446,500
94,83,99,97,92,465,465,500
80,85,91,90,93,439,439,500
95,82,93,99,96,465,465,500
80,97,84,80,88,429,429,500
92,96,95,86,89,458,458,500
83,83,98,89,89,442,442,500
88,90,86,93,99,456,456,500
89,86,90,90,88,443,443,500
86,96,96,91,82,451,451,500
80,99,90,88,98,455,455,500
83,84,81,97,84,429,429,500
82,90,92,82,91,437,437,500
81,95,83,93,94,446,446,500
91,90,82,97,93,453,453,500
81,90,87,84,96,438,438,500
85,93,82,99,95,454,454,500
80,97,97,91,83,448,448,500
97,82,99,85,95,458,458,500
95,95,91,97,87,465,465,500
83,99,84,94,92,452,452,500
92,84,84,93,82,435,435,500
99,92,93,99,81,464,464,500
98,88,81,86,94,447,447,500
80,93,81,85,97,436,436,500
84,95,96,87,92,454,454,500
84,81,85,94,90,434,434,500
91,98,92,85,87,453,453,500
87,87,92,99,93,458,458,500
88,95,92,92,83,450,450,500
89,90,92,82,88,441,441,500
86,85,84,83,93,431,431,500
95,98,85,98,96,472,472,500
94,84,90,90,95,453,453,500
87,93,97,96,84,457,457,500
99,87,82,99,86,453,453,500
95,87,98,91,89,460,460,500
81,94,88,93,88,444,444,500
81,80,97,84,81,423,423,500
82,89,96,99,91,457,457,500
87,87,81,96,89,440,440,500
96,85,98,80,90,449,449,500
98,97,92,84,85,456,456,500
90,98,87,93,90,458,458,500
88,80,85,88,80,421,421,500
81,97,94,85,97,454,454,500
95,97,91,96,88,467,467,500
97,98,99,82,88,464,464,500
90,97,92,85,91,455,455,500
84,83,91,81,98,437,437,500
94,86,87,92,91,450,450,500
90,91,81,83,99,444,444,500
94,94,84,83,95,450,450,500
85,91,91,90,88,445,445,500
86,92,87,89,91,445,445,500
84,80,90,86,82,422,422,500
95,90,91,85,99,460,460,500
99,96,90,80,84,449,449,500
92,89,94,88,87,450,450,500
97,99,94,85,88,463,463,500
85,87,88,93,83,436,436,500
98,92,95,81,90,456,456,500
81,83,91,92,80,427,427,500
82,91,88,84,96,441,441,500
90,80,92,86,97,445,445,500
97,85,91,87,91,451,451,500
92,82,91,85,86,436,436,500
82,93,88,92,98,453,453,500
92,97,84,95,88,456,456,500
84,99,80,98,81,442,442,500
97,84,85,98,97,461,461,500
97,85,84,98,98,462,462,500
82,91,95,98,91,457,457,500
88,98,81,84,98,449,449,500
93,83,94,99,97,466,466,500
86,85,86,86,94,437,437,500
90,86,87,83,85,431,431,500
95,98,99,91,85,468,468,500
83,91,93,85,98,450,450,500
80,88,91,83,95,437,437,500
95,80,93,89,87,444,444,500
95,88,82,90,99,454,454,500
92,80,92,82,96,442,442,500
91,92,80,99,86,448,448,500
94,84,84,91,96,449,449,500
97,92,92,96,80,457,457,500
96,84,89,85,91,445,445,500
93,91,81,96,86,447,447,500
87,85,84,97,84,437,437,500
83,93,93,91,85,445,445,500
88,96,95,92,89,460,460,500
80,90,91,85,97,443,443,500
82,87,97,94,83,443,443,500
89,84,90,89,92,444,444,500
87,89,80,90,94,440,440,500
90,83,99,85,95,452,452,500
82,94,89,89,85,439,439,500
91,84,95,94,80,444,444,500
90,81,86,90,96,443,443,500
93,94,85,80,81,433,433,500
82,87,95,99,84,447,447,500
82,99,84,84,92,441,441,500
92,81,97,85,95,450,450,500
97,86,83,96,95,457,457,500
84,99,83,83,97,446,446,500
82,99,93,89,92,455,455,500
98,93,81,83,92,447,447,500
99,93,87,82,91,452,452,500
86,87,96,92,81,442,442,500
80,83,80,87,86,416,416,500
94,99,95,92,92,472,472,500
86,84,94,81,81,426,426,500
81,91,93,82,90,437,437,500
93,85,87,83,92,440,440,500
81,98,99,93,94,465,465,500
83,84,92,85,94,438,438,500
82,89,83,85,92,431,431,500
93,83,88,87,96,447,447,500
86,93,81,89,88,437,437,500
98,87,91,97,84,457,457,500
93,97,93,96,99,478,478,500
80,92,99,90,95,456,456,500
91,94,86,84,84,439,439,500
97,83,81,96,97,454,454,500
83,98,91,99,89,460,460,500
88,99,96,96,88,467,467,500
99,97,82,84,80,442,442,500
98,97,94,92,90,471,471,500
81,90,92,98,91,452,452,500
83,90,94,86,89,442,442,500
91,91,82,93,86,443,443,500
93,90,83,99,81,446,446,500
91,94,83,99,99,466,466,500
91,90,81,97,95,454,454,500
86,81,95,81,82,425,425,500
93,85,82,87,91,438,438,500
96,84,88,92,90,450,450,500
98,80,92,82,84,436,436,500
87,82,93,83,92,437,437,500
94,90,91,93,84,452,452,500
84,90,89,88,87,438,438,500
90,80,94,82,96,442,442,500
80,94,86,93,95,448,448,500
98,98,91,84,83,454,454,500
95,94,80,80,99,448,448,500
90,88,99,81,95,453,453,500
91,98,85,91,93,458,458,500
96,94,95,89,89,463,463,500
86,88,92,93,97,456,456,500
95,90,99,94,98,476,476,500
81,98,93,95,84,451,451,500
91,91,93,94,96,465,465,500
99,85,92,80,83,439,439,500
90,90,87,97,94,458,458,500
94,85,92,96,94,461,461,500
88,80,99,81,88,436,436,500
92,97,83,83,99,454,454,500
94,82,85,86,99,446,446,500
95,91,83,87,88,444,444,500
82,96,89,97,99,463,463,500
97,91,92,96,91,467,467,500
93,87,87,89,81,437,437,500
81,95,99,95,94,464,464,500
86,96,94,94,80,450,450,500
86,81,80,99,95,441,441,500
88,95,94,81,87,445,445,500
84,82,80,81,81,408,408,500
88,99,80,98,87,452,452,500
84,96,80,87,84,431,431,500
83,80,94,82,82,421,421,500
80,88,98,94,83,443,443,500
98,84,80,96,97,455,455,500
92,83,93,99,80,447,447,500
96,90,93,99,88,466,466,500
92,90,81,86,99,448,448,500
87,95,93,80,89,444,444,500
89,85,95,99,89,457,457,500
89,91,96,88,92,456,456,500
89,99,88,81,81,438,438,500
85,96,90,82,95,448,448,500
80,92,92,84,95,443,443,500
91,86,87,97,80,441,441,500
87,90,91,91,85,444,444,500
89,86,91,96,83,445,445,500
95,89,99,88,85,456,456,500
84,80,97,82,87,430,430,500
85,91,93,93,87,449,449,500
83,87,82,97,88,437,437,500
99,88,81,90,94,452,452,500
87,91,94,86,92,450,450,500
99,94,86,91,85,455,455,500
89,95,92,98,85,459,459,500
92,85,88,82,87,434,434,500
90,89,86,84,81,430,430,500
81,95,88,84,91,439,439,500
96,89,81,88,95,449,449,500
80,83,97,84,98,442,442,500
80,98,82,90,92,442,442,500
91,98,83,80,88,440,440,500
90,89,86,99,86,450,450,500
83,84,90,84,90,431,431,500
84,96,87,98,94,459,459,500
83,88,97,87,81,436,436,500
90,95,82,99,96,462,462,500
98,91,90,87,99,465,465,500
88,96,90,96,83,453,453,500
93,88,95,99,86,461,461,500
83,93,95,99,90,460,460,500
91,99,80,89,95,454,454,500
84,88,99,82,91,444,444,500
80,89,89,93,99,450,450,500
97,84,97,92,80,450,450,500
96,84,81,87,83,431,431,500
83,96,99,93,81,452,452,500
82,81,82,81,80,406,406,500
82,86,98,89,87,442,442,500
95,93,80,83,98,449,449,500
94,87,90,89,93,453,453,500
82,87,87,88,85,429,429,500
97,84,92,93,85,451,451,500
92,86,89,88,98,453,453,500
90,88,99,91,90,458,458,500
95,80,81,88,86,430,430,500
96,97,90,91,97,471,471,500
86,99,80,81,97,443,443,500
85,83,87,82,86,423,423,500
82,91,85,98,82,438,438,500
94,85,89,94,94,456,456,500
88,88,90,99,96,461,461,500
86,93,83,85,93,440,440,500
96,96,90,87,80,449,449,500
80,96,80,80,95,431,431,500
96,92,98,96,91,473,473,500
94,80,98,83,91,446,446,500
81,86,87,90,87,431,431,500
95,97,80,97,93,462,462,500
80,94,92,86,81,433,433,500
82,86,89,97,80,434,434,500
94,92,86,96,81,449,449,500
94,89,91,96,86,456,456,500
81,81,84,90,96,432,432,500
99,80,97,92,91,459,459,500
82,99,90,92,93,456,456,500
95,84,87,86,80,432,432,500
86,92,81,80,94,433,433,500
85,89,99,84,80,437,437,500
81,95,91,81,85,433,433,500
92,88,91,81,97,449,449,500
86,92,98,91,82,449,449,500
82,87,98,86,84,437,437,500
98,99,82,88,81,448,448,500
94,87,80,92,91,444,444,500
92,82,87,94,82,437,437,500
95,91,82,89,85,442,442,500
85,80,88,83,85,421,421,500
81,98,93,94,93,459,459,500
93,83,95,91,87,449,449,500
92,97,83,81,95,448,448,500
88,93,96,80,97,454,454,500
98,98,88,82,98,464,464,500
99,87,85,95,86,452,452,500
98,87,89,87,91,452,452,500
95,93,90,95,86,459,459,500
94,87,90,94,91,456,456,500
81,97,86,82,94,440,440,500
87,86,85,99,91,448,448,500
89,81,85,92,91,438,438,500
86,98,80,94,94,452,452,500
91,96,80,89,93,449,449,500
95,83,90,97,94,459,459,500
80,94,91,85,80,430,430,500
84,95,83,86,92,440,440,500
91,94,81,89,99,454,454,500
94,85,99,91,92,461,461,500
99,83,89,89,84,444,444,500
88,94,97,97,83,459,459,500
93,94,87,87,82,443,443,500
85,92,89,92,94,452,452,500
88,98,81,89,93,449,449,500
80,99,87,90,89,445,445,500
96,83,91,82,81,433,433,500
87,90,94,96,87,454,454,500
81,89,90,97,84,441,441,500
87,83,81,87,99,437,437,500
95,95,93,90,82,455,455,500
91,95,87,92,89,454,454,500
97,85,80,92,98,452,452,500
90,85,92,92,98,457,457,500
89,90,91,84,86,440,440,500
89,82,90,92,93,446,446,500
85,93,92,80,88,438,438,500
93,83,89,80,89,434,434,500
91,85,81,98,87,442,442,500
98,97,87,89,82,453,453,500
97,87,95,86,95,460,460,500
99,81,90,87,86,443,443,500
95,96,80,98,80,449,449,500
96,96,93,85,83,453,453,500
88,84,84,98,89,443,443,500
96,92,98,89,92,467,467,500
88,95,97,89,80,449,449,500
92,86,98,88,96,460,460,500
92,98,80,87,82,439,439,500
81,91,90,91,83,436,436,500
91,84,84,91,87,437,437,500
88,80,97,82,98,445,445,500
85,81,92,80,83,421,421,500
91,87,85,92,99,454,454,500
94,85,96,88,97,460,460,500
85,95,83,84,96,443,443,500
86,91,83,87,99,446,446,500
94,99,88,87,87,455,455,500
81,91,95,90,95,452,452,500
86,87,89,85,86,433,433,500
89,84,95,96,90,454,454,500
90,92,90,87,98,457,457,500
86,93,83,88,94,444,444,500
92,80,86,97,89,444,444,500
88,84,84,92,96,444,444,500
86,95,94,90,92,457,457,500
94,87,87,83,97,448,448,500
94,96,92,84,98,464,464,500
80,98,91,88,99,456,456,500
94,88,89,97,99,467,467,500
86,95,93,84,88,446,446,500
99,82,95,88,92,456,456,500
82,92,87,82,82,425,425,500
91,92,91,88,84,446,446,500
83,90,98,85,92,448,448,500
93,91,95,88,87,454,454,500
93,89,81,98,82,443,443,500
90,94,96,81,90,451,451,500
87,80,99,81,81,428,428,500
92,94,82,88,91,447,447,500
90,82,83,89,96,440,440,500
93,91,99,85,96,464,464,500
86,86,95,80,81,428,428,500
96,89,98,94,80,457,457,500
84,93,89,95,97,458,458,500
95,98,89,84,80,446,446,500
97,83,88,89,95,452,452,500
99,84,92,87,97,459,459,500
82,97,80,89,99,447,447,500
85,89,98,84,98,454,454,500
97,89,94,90,85,455,455,500
84,86,91,94,95,450,450,500
97,93,97,97,88,472,472,500
85,91,96,97,80,449,449,500
83,99,99,95,88,464,464,500
82,85,90,87,97,441,441,500
87,95,95,83,97,457,457,500
94,90,86,84,93,447,447,500
89,91,87,85,90,442,442,500
82,81,91,86,89,429,429,500
86,98,94,98,88,464,464,500
89,87,80,85,95,436,436,500
85,88,85,98,88,444,444,500
81,86,99,86,93,445,445,500
84,99,84,96,82,445,445,500
93,88,89,81,95,446,446,500
92,84,90,89,90,445,445,500
87,85,88,80,90,430,430,500
97,90,99,96,95,477,477,500
87,96,86,82,98,449,449,500
96,81,87,89,92,445,445,500
96,80,99,95,81,451,451,500
80,87,93,98,90,448,448,500
82,86,97,81,88,434,434,500
93,90,84,96,81,444,444,500
98,85,90,81,82,436,436,500
86,81,98,95,88,448,448,500
83,99,99,93,85,459,459,500
88,94,90,92,84,448,448,500
95,89,86,97,91,458,458,500
92,92,90,99,95,468,468,500
81,95,88,99,94,457,457,500
96,82,83,82,82,425,425,500
89,87,91,90,82,439,439,500
95,82,80,94,82,433,433,500
96,81,85,87,88,437,437,500
81,95,85,83,83,427,427,500
94,96,98,93,83,464,464,500
88,96,92,87,81,444,444,500
83,80,98,84,97,442,442,500
85,81,96,80,92,434,434,500
87,80,90,85,80,422,422,500
86,88,97,82,88,441,441,500
89,98,93,99,80,459,459,500
88,88,88,88,85,437,437,500
96,89,94,82,84,445,445,500
97,99,84,85,83,448,448,500
88,94,86,92,93,453,453,500
88,91,85,90,96,450,450,500
95,86,93,91,86,451,451,500
89,84,98,82,83,436,436,500
85,90,80,97,98,450,450,500
93,89,84,86,95,447,447,500
99,94,86,85,98,462,462,500
93,96,94,85,80,448,448,500
93,85,88,96,96,458,458,500
92,94,91,82,90,449,449,500
86,91,99,99,95,470,470,500
83,99,97,96,88,463,463,500
94,84,86,93,97,454,454,500
86,83,81,81,84,415,415,500
88,82,80,81,82,413,413,500
85,96,97,84,91,453,453,500
84,80,89,92,90,435,435,500
86,95,96,88,97,462,462,500
85,83,98,91,83,440,440,500
91,84,97,99,96,467,467,500
83,82,89,88,92,434,434,500
92,87,98,82,88,447,447,500
92,85,82,82,96,437,437,500
88,83,92,87,86,436,436,500
98,87,99,87,81,452,452,500
91,90,86,96,95,458,458,500
89,88,99,94,85,455,455,500
84,96,84,87,90,441,441,500
87,90,84,83,94,438,438,500
89,88,95,91,86,449,449,500
92,83,94,93,83,445,445,500
96,83,92,88,80,439,439,500
86,83,95,86,89,439,439,500
83,81,85,94,94,437,437,500
97,81,95,91,81,445,445,500
84,80,89,95,80,428,428,500
99,90,92,90,85,456,456,500
86,95,91,82,83,437,437,500
87,98,85,94,93,457,457,500
84,87,87,99,87,444,444,500
88,93,93,89,90,453,453,500
91,96,80,84,90,441,441,500
90,96,89,98,95,468,468,500
95,88,85,89,85,442,442,500
99,87,93,80,86,445,445,500
96,99,91,83,87,456,456,500
86,87,83,91,80,427,427,500
92,93,94,93,82,454,454,500
91,94,81,93,87,446,446,500
97,90,94,93,93,467,467,500
92,98,81,86,89,446,446,500
97,80,86,93,98,454,454,500
90,87,84,89,88,438,438,500
92,84,86,82,94,438,438,500
83,91,91,91,93,449,449,500
80,98,85,85,88,436,436,500
97,94,81,96,93,461,461,500
93,81,89,95,87,445,445,500
84,81,94,88,91,438,438,500
98,98,90,95,83,464,464,500
84,85,89,92,87,437,437,500
85,91,81,93,90,440,440,500
86,87,89,89,94,445,445,500
98,91,91,91,86,457,457,500
81,89,94,99,89,452,452,500
96,90,98,93,80,457,457,500
99,98,92,92,85,466,466,500
97,98,93,98,82,468,468,500
89,92,85,80,86,432,432,500
81,90,99,80,91,441,441,500
84,88,98,98,99,467,467,500
99,86,95,97,92,469,469,500
86,98,81,87,98,450,450,500
95,84,99,94,94,466,466,500
83,85,92,98,93,451,451,500
86,97,95,96,94,468,468,500
86,89,95,93,86,449,449,500
85,88,87,95,93,448,448,500
99,81,93,80,81,434,434,500
85,92,89,84,92,442,442,500
83,82,97,95,84,441,441,500
88,93,98,99,93,471,471,500
84,92,84,96,93,449,449,500
81,82,89,92,84,428,428,500
97,85,97,93,92,464,464,500
98,88,99,95,91,471,471,500
98,82,88,88,94,450,450,500
89,98,94,82,97,460,460,500
99,81,83,97,87,447,447,500
84,84,85,85,99,437,437,500
92,84,83,96,90,445,445,500
95,90,94,84,95,458,458,500
89,99,97,96,88,469,469,500
98,90,91,95,99,473,473,500
86,87,81,88,82,424,424,500
87,98,80,89,90,444,444,500
98,80,93,95,94,460,460,500
81,87,82,81,80,411,411,500
97,94,98,82,88,459,459,500
95,95,94,88,80,452,452,500
86,95,92,98,91,462,462,500
92,94,91,81,84,442,442,500
97,92,90,82,96,457,457,500
98,99,92,92,96,477,477,500
81,97,86,86,83,433,433,500
88,81,84,82,93,428,428,500
94,95,87,84,83,443,443,500
99,95,83,96,87,460,460,500
93,85,82,82,92,434,434,500
89,98,80,94,90,451,451,500
98,82,82,83,94,439,439,500
80,88,88,85,82,423,423,500
98,80,86,93,82,439,439,500
87,83,94,91,99,454,454,500
85,85,90,93,92,445,445,500
81,98,96,83,92,450,450,500
97,82,93,88,83,443,443,500
92,97,88,99,99,475,475,500
98,99,96,92,96,481,481,500
91,84,97,81,92,445,445,500
81,95,97,84,88,445,445,500
98,81,89,82,92,442,442,500
91,94,84,93,86,448,448,500
81,82,82,93,80,418,418,500
83,87,82,82,85,419,419,500
96,98,96,84,90,464,464,500
87,88,99,83,92,449,449,500
97,96,89,81,87,450,450,500
91,86,86,92,92,447,447,500
95,99,90,94,83,461,461,500
80,86,89,81,88,424,424,500
94,87,86,93,99,459,459,500
88,96,84,82,86,436,436,500
82,90,94,81,92,439,439,500
91,87,92,94,96,460,460,500
99,89,83,92,94,457,457,500
93,85,90,92,80,440,440,500
87,87,94,81,99,448,448,500
96,88,91,82,92,449,449,500
86,89,90,83,80,428,428,500
98,95,86,83,94,456,456,500
96,81,86,86,84,433,433,500
97,94,87,96,95,469,469,500
91,91,96,80,81,439,439,500
80,91,96,97,80,444,444,500
95,81,91,96,98,461,461,500
94,87,86,91,91,449,449,500
88,98,80,90,92,448,448,500
85,81,92,87,88,433,433,500
98,94,87,98,88,465,465,500
92,93,95,89,80,449,449,500
97,82,92,91,94,456,456,500
81,84,88,99,92,444,444,500
92,90,99,89,84,454,454,500
98,90,99,81,80,448,448,500
94,96,93,99,82,464,464,500
97,83,85,88,92,445,445,500
90,89,84,84,80,427,427,500
98,99,85,91,88,461,461,500
83,82,91,92,80,428,428,500
84,91,95,98,83,451,451,500
88,87,99,82,89,445,445,500
84,94,91,84,88,441,441,500
91,99,93,86,97,466,466,500
91,84,94,91,87,447,447,500
85,89,94,86,85,439,439,500
83,81,99,89,88,440,440,500
94,83,92,91,82,442,442,500
83,88,92,97,96,456,456,500
85,83,85,80,97,430,430,500
93,81,82,97,84,437,437,500
92,92,83,92,82,441,441,500
85,90,89,84,92,440,440,500
94,99,91,88,81,453,453,500
80,99,87,95,95,456,456,500
93,89,99,98,84,463,463,500
87,85,90,94,87,443,443,500
90,82,82,96,86,436,436,500
95,88,99,93,92,467,467,500
83,85,97,99,97,461,461,500
87,83,86,83,85,424,424,500
88,97,95,98,90,468,468,500
95,85,99,84,86,449,449,500
99,93,85,92,97,466,466,500
95,90,87,89,92,453,453,500
86,88,98,95,86,453,453,500
82,97,83,98,81,441,441,500
85,94,83,86,85,433,433,500
94,84,82,91,98,449,449,500
80,90,88,81,94,433,433,500
97,97,94,98,91,477,477,500
84,91,90,90,91,446,446,500
80,98,92,90,94,454,454,500
87,87,96,87,82,439,439,500
82,99,97,84,89,451,451,500
92,96,86,92,85,451,451,500
93,85,93,86,88,445,445,500
87,87,98,85,94,451,451,500
86,90,91,81,82,430,430,500
97,96,95,80,98,466,466,500
83,83,93,81,99,439,439,500
81,99,88,85,91,444,444,500
93,97,88,91,91,460,460,500
97,99,88,87,90,461,461,500
99,93,92,99,87,470,470,500
98,89,98,98,90,473,473,500
95,93,97,88,81,454,454,500
81,84,92,90,91,438,438,500
81,85,82,94,92,434,434,500
87,98,99,98,94,476,476,500
83,92,84,82,90,431,431,500
96,91,83,93,89,452,452,500
92,91,99,84,96,462,462,500
91,87,96,81,88,443,443,500
90,85,88,97,86,446,446,500
89,94,81,94,90,448,448,500
94,86,89,81,87,437,437,500
94,84,84,91,88,441,441,500
95,85,97,80,92,449,449,500
93,90,87,96,95,461,461,500
94,83,92,82,86,437,437,500
80,90,89,94,80,433,433,500
97,80,94,99,87,457,457,500
82,82,87,83,84,418,418,500
99,91,83,99,85,457,457,500
80,86,89,80,91,426,426,500
91,82,97,87,83,440,440,500
94,86,83,90,98,451,451,500
85,86,94,99,98,462,462,500
83,85,82,87,96,433,433,500
97,90,83,98,97,465,465,500
95,91,84,85,97,452,452,500
82,99,86,86,84,437,437,500
82,83,90,89,88,432,432,500
81,84,94,97,82,438,438,500
94,86,91,98,95,464,464,500
88,83,87,95,90,443,443,500
82,99,83,96,85,445,445,500
92,88,96,82,80,438,438,500
99,84,87,97,91,458,458,500
94,94,95,84,91,458,458,500
91,90,98,86,93,458,458,500
82,84,83,99,86,434,434,500
93,98,95,81,99,466,466,500
83,84,85,95,89,436,436,500
88,87,88,84,95,442,442,500
99,93,85,95,91,463,463,500
92,95,96,84,99,466,466,500
88,81,94,96,86,445,445,500
80,84,94,90,90,438,438,500
88,97,88,85,82,440,440,500
83,92,86,84,99,444,444,500
88,82,90,87,82,429,429,500
99,94,86,84,92,455,455,500
87,87,95,97,87,453,453,500
87,97,80,87,85,436,436,500
88,91,96,99,99,473,473,500
86,96,91,89,96,458,458,500
95,88,80,84,90,437,437,500
97,84,86,94,93,454,454,500
89,90,95,95,82,451,451,500
98,97,90,81,82,448,448,500
85,80,90,93,96,444,444,500
82,93,96,90,99,460,460,500
93,97,91,82,83,446,446,500
95,88,96,90,89,458,458,500
95,98,80,95,83,451,451,500
87,97,88,90,98,460,460,500
82,86,92,80,84,424,424,500
97,85,98,83,97,460,460,500
90,82,89,92,87,440,440,500
94,94,94,95,87,464,464,500
86,89,98,82,93,448,448,500
81,97,83,93,88,442,442,500
81,91,83,80,91,426,426,500
92,91,83,86,83,435,435,500
81,97,96,84,89,447,447,500
85,99,88,87,82,441,441,500
82,97,91,86,97,453,453,500
89,81,96,88,95,449,449,500
81,95,82,81,99,438,438,500
92,97,95,80,84,448,448,500
92,90,85,89,84,440,440,500
94,84,86,96,80,440,440,500
91,81,93,85,89,439,439,500
88,81,98,97,98,462,462,500
80,98,82,94,81,435,435,500
97,94,89,94,90,464,464,500
88,90,97,97,91,463,463,500
90,82,97,95,94,458,458,500
87,90,92,94,93,456,456,500
85,87,87,97,96,452,452,500
92,85,82,95,93,447,447,500
89,87,85,98,98,457,457,500
87,91,99,81,90,448,448,500
87,83,83,87,88,428,428,500
80,82,94,90,98,444,444,500
80,91,98,91,88,448,448,500
87,88,81,84,87,427,427,500
88,93,93,89,82,445,445,500
84,99,83,89,83,438,438,500
98,92,98,96,86,470,470,500
96,85,96,89,85,451,451,500
91,81,83,91,92,438,438,500
83,88,84,82,86,423,423,500
88,93,86,95,97,459,459,500
90,82,94,80,90,436,436,500
93,95,86,85,95,454,454,500
99,92,91,86,89,457,457,500
84,95,97,80,90,446,446,500
96,91,88,84,90,449,449,500
86,94,96,82,94,452,452,500
94,83,93,83,99,452,452,500
88,97,80,91,97,453,453,500
86,83,94,95,92,450,450,500
98,80,86,94,88,446,446,500
96,96,86,87,96,461,461,500
99,94,96,98,87,474,474,500
80,93,85,88,94,440,440,500
80,99,86,81,80,426,426,500
96,90,91,99,85,461,461,500
97,96,89,85,96,463,463,500
98,97,86,88,89,458,458,500
90,97,88,82,83,440,440,500
98,83,83,82,90,436,436,500
81,98,91,90,92,452,452,500
99,97,88,98,90,472,472,500
91,86,84,95,86,442,442,500
97,89,82,95,89,452,452,500
87,80,89,85,91,432,432,500
97,93,84,91,87,452,452,500
99,86,91,96,91,463,463,500
99,92,84,85,82,442,442,500
91,99,93,90,85,458,458,500
83,90,90,94,85,442,442,500
90,99,86,86,83,444,444,500
89,84,82,88,98,441,441,500
88,98,83,89,81,439,439,500
86,93,93,80,97,449,449,500
85,90,94,82,89,440,440,500
87,98,92,88,84,449,449,500
98,87,98,97,95,475,475,500
98,96,89,88,88,459,459,500
93,90,96,95,84,458,458,500
80,83,83,93,93,432,432,500
93,90,82,81,96,442,442,500
81,84,88,86,80,419,419,500
87,89,91,91,83,441,441,500
87,87,94,81,98,447,447,500
96,80,88,99,92,455,455,500
95,90,92,97,93,467,467,500
94,87,84,98,81,444,444,500
97,98,96,87,87,465,465,500
96,96,98,86,99,475,475,500
96,92,96,85,86,455,455,500
89,94,84,94,87,448,448,500
83,98,94,96,95,466,466,500
95,85,96,94,83,453,453,500
80,88,98,85,87,438,438,500
90,82,94,85,87,438,438,500
98,95,86,97,92,468,468,500
95,84,86,84,87,436,436,500
82,96,80,97,92,447,447,500
94,91,96,95,85,461,461,500
87,97,98,83,91,456,456,500
80,88,87,95,82,432,432,500
93,85,92,87,87,444,444,500
88,99,95,86,95,463,463,500
85,88,93,96,84,446,446,500
81,81,85,88,96,431,431,500
92,93,97,93,80,455,455,500
95,90,97,89,80,451,451,500
92,89,97,99,85,462,462,500
94,97,84,97,85,457,457,500
90,91,97,81,80,439,439,500
94,82,84,87,99,446,446,500
81,95,94,82,92,444,444,500
84,96,89,96,94,459,459,500
81,82,99,90,86,438,438,500
88,81,98,92,83,442,442,500
87,97,83,88,92,447,447,500
93,99,85,93,89,459,459,500
87,87,84,97,81,436,436,500
81,85,86,99,96,447,447,500
81,94,89,88,80,432,432,500
94,90,98,88,98,468,468,500
82,81,90,91,80,424,424,500
96,89,90,87,87,449,449,500
85,93,83,98,80,439,439,500
91,81,90,93,81,436,436,500
90,97,95,85,99,466,466,500
97,97,81,91,80,446,446,500
92,90,85,84,84,435,435,500
85,91,87,91,86,440,440,500
80,96,85,97,85,443,443,500
80,83,84,91,94,432,432,500
82,89,87,83,86,427,427,500
81,80,82,87,97,427,427,500
87,91,87,82,99,446,446,500
84,82,94,92,91,443,443,500
99,87,98,90,90,464,464,500
82,80,80,99,89,430,430,500
90,98,84,80,96,448,448,500
89,99,85,98,89,460,460,500
99,86,80,85,82,432,432,500
99,81,98,98,88,464,464,500
96,96,80,94,85,451,451,500
98,91,87,94,93,463,463,500
98,82,87,83,97,447,447,500
85,94,93,87,87,446,446,500
85,99,86,98,80,448,448,500
86,87,89,98,97,457,457,500
97,94,81,80,90,442,442,500
86,95,96,87,97,461,461,500
84,85,89,84,99,441,441,500
94,92,80,85,81,432,432,500
84,84,83,96,98,445,445,500
87,85,90,83,88,433,433,500
80,98,81,86,85,430,430,500
91,86,84,84,83,428,428,500
89,90,97,85,94,455,455,500
95,86,85,88,96,450,450,500
93,92,91,96,97,469,469,500
84,85,89,91,99,448,448,500
85,93,86,91,94,449,449,500
83,81,87,83,86,420,420,500
95,84,92,81,98,450,450,500
86,84,80,85,97,432,432,500
89,80,84,92,87,432,432,500
99,88,84,82,95,448,448,500
97,87,99,87,82,452,452,500
88,97,86,88,90,449,449,500
81,85,83,84,83,416,416,500
95,84,88,94,91,452,452,500
83,98,83,91,84,439,439,500
86,87,99,81,92,445,445,500
95,90,80,98,91,454,454,500
99,84,89,85,88,445,445,500
97,87,85,84,91,444,444,500
81,95,85,89,86,436,436,500
86,92,90,92,92,452,452,500
93,97,84,91,99,464,464,500
98,80,88,90,84,440,440,500
88,81,80,86,99,434,434,500
96,83,80,92,86,437,437,500
95,87,97,81,80,440,440,500
85,96,98,87,94,460,460,500
91,86,90,83,80,430,430,500
84,96,80,80,87,427,427,500
91,87,94,86,85,443,443,500
83,82,82,93,90,430,430,500
95,96,80,95,84,450,450,500
85,93,85,81,83,427,427,500
81,93,98,98,80,450,450,500
94,80,94,82,85,435,435,500
87,84,99,90,86,446,446,500
84,98,85,91,96,454,454,500
86,80,81,87,84,418,418,500
98,93,82,87,89,449,449,500
92,87,84,84,90,437,437,500
99,81,90,93,93,456,456,500
92,81,83,95,84,435,435,500
83,96,99,87,96,461,461,500
98,99,87,99,95,478,478,500
84,94,93,99,83,453,453,500
93,97,95,85,99,469,469,500
97,94,92,95,98,476,476,500
80,89,85,85,80,419,419,500
88,86,87,96,96,453,453,500
93,93,90,86,88,450,450,500
95,84,92,95,86,452,452,500
85,92,97,87,83,444,444,500
90,82,84,97,99,452,452,500
94,80,82,99,94,449,449,500
95,86,96,82,83,442,442,500
82,87,88,95,83,435,435,500
81,92,88,87,98,446,446,500
85,88,81,85,85,424,424,500
96,80,92,94,92,454,454,500
93,97,83,88,86,447,447,500
84,97,81,96,81,439,439,500
95,83,96,91,82,447,447,500
99,93,83,82,89,446,446,500
95,98,85,99,91,468,468,500
87,95,98,83,96,459,459,500
88,93,89,91,95,456,456,500
96,93,94,91,95,469,469,500
89,95,94,99,93,470,470,500
81,82,90,85,94,432,432,500
88,88,89,95,87,447,447,500
99,85,85,94,98,461,461,500
95,80,93,89,82,439,439,500
85,84,95,86,85,435,435,500
86,93,83,99,98,459,459,500
88,82,88,86,97,441,441,500
90,91,81,82,94,438,438,500
98,99,92,92,95,476,476,500
95,89,81,86,84,435,435,500
91,89,82,86,95,443,443,500
84,92,99,95,97,467,467,500
87,86,94,90,96,453,453,500
96,81,97,99,97,470,470,500
94,97,85,87,89,452,452,500
93,80,83,93,97,446,446,500
82,82,92,83,82,421,421,500
85,81,84,90,87,427,427,500
80,91,82,81,88,422,422,500
94,98,99,82,90,463,463,500
99,96,84,92,85,456,456,500
88,86,99,94,85,452,452,500
93,99,92,88,94,466,466,500
83,98,89,90,99,459,459,500
90,86,83,87,99,445,445,500
81,96,93,97,80,447,447,500
90,87,84,97,97,455,455,500
88,82,80,91,81,422,422,500
91,91,87,93,89,451,451,500
95,97,93,90,80,455,455,500
82,84,82,89,96,433,433,500
97,88,87,84,90,446,446,500
90,83,91,81,92,437,437,500
93,88,85,87,80,433,433,500
95,83,84,92,99,453,453,500
92,87,82,99,86,446,446,500
99,95,94,99,84,471,471,500
81,84,92,89,81,427,427,500
94,97,85,91,84,451,451,500
95,87,84,92,89,447,447,500
91,85,84,82,80,422,422,500
96,85,99,98,94,472,472,500
86,93,81,86,95,441,441,500
87,92,98,97,91,465,465,500
85,97,95,92,91,460,460,500
91,87,88,96,81,443,443,500
80,82,92,88,93,435,435,500
86,98,80,88,89,441,441,500
81,94,89,98,84,446,446,500
94,90,96,91,95,466,466,500
90,96,84,99,96,465,465,500
91,87,89,97,81,445,445,500
92,94,95,93,87,461,461,500
91,90,87,83,95,446,446,500
87,94,97,87,96,461,461,500
99,85,97,85,84,450,450,500
85,89,92,80,83,429,429,500
80,85,92,92,89,438,438,500
99,91,97,86,80,453,453,500
98,88,84,86,86,442,442,500
80,93,92,91,90,446,446,500
98,99,83,87,92,459,459,500
95,92,85,90,98,460,460,500
81,86,92,98,80,437,437,500
98,97,85,97,83,460,460,500
99,92,89,95,91,466,466,500
94,97,93,85,92,461,461,500
89,96,83,96,82,446,446,500
97,85,91,87,92,452,452,500
98,89,81,90,98,456,456,500
85,97,92,95,91,460,460,500
97,94,92,83,99,465,465,500
90,98,89,95,83,455,455,500
82,88,87,98,93,448,448,500
87,89,93,96,88,453,453,500
89,95,95,94,96,469,469,500
94,87,80,85,85,431,431,500
94,90,82,90,92,448,448,500
98,89,98,81,90,456,456,500
95,92,97,95,84,463,463,500
99,90,89,91,93,462,462,500
98,80,82,94,95,449,449,500
82,80,91,84,93,430,430,500
85,97,82,95,93,452,452,500
94,82,84,89,80,429,429,500
97,98,80,94,84,453,453,500
99,93,99,84,88,463,463,500
91,80,84,95,93,443,443,500
97,90,85,94,95,461,461,500
91,91,91,89,89,451,451,500
99,94,90,85,97,465,465,500
99,83,85,94,80,441,441,500
81,87,94,94,92,448,448,500
85,82,94,92,92,445,445,500
97,99,97,95,97,485,485,500
97,80,88,90,85,440,440,500
89,85,87,96,96,453,453,500
83,92,83,97,99,454,454,500
91,98,85,93,84,451,451,500
86,98,97,83,87,451,451,500
80,91,92,85,93,441,441,500
89,84,82,82,88,425,425,500
98,88,83,92,97,458,458,500
91,90,80,88,85,434,434,500
89,97,93,88,97,464,464,500
88,97,99,84,97,465,465,500
91,81,83,80,95,430,430,500
97,82,91,93,83,446,446,500
91,98,98,85,93,465,465,500
88,90,97,86,92,453,453,500
95,83,81,88,95,442,442,500
87,88,94,88,82,439,439,500
89,93,89,84,80,435,435,500
89,82,99,81,96,447,447,500
95,96,82,84,90,447,447,500
91,96,83,95,80,445,445,500
94,86,87,86,92,445,445,500
98,83,95,89,85,450,450,500
96,92,85,88,83,444,444,500
89,95,95,84,92,455,455,500
94,96,93,91,92,466,466,500
90,99,95,90,95,469,469,500
87,84,99,97,89,456,456,500
85,91,85,85,83,429,429,500
85,87,95,93,95,455,455,500
82,85,97,84,86,434,434,500
90,87,88,88,95,448,448,500
90,89,87,92,90,448,448,500
86,98,99,83,95,461,461,500
81,85,80,82,86,414,414,500
85,80,98,83,87,433,433,500
91,99,87,93,97,467,467,500
89,86,82,87,97,441,441,500
86,94,85,80,83,428,428,500
84,96,95,92,88,455,455,500
93,97,95,97,97,479,479,500
82,86,80,82,92,422,422,500
83,99,87,95,93,457,457,500
91,96,98,89,91,465,465,500
97,81,82,81,94,435,435,500
99,85,87,90,96,457,457,500
89,94,88,80,83,434,434,500
82,81,97,84,96,440,440,500
98,87,92,89,88,454,454,500
96,85,81,99,88,449,449,500
83,82,93,80,88,426,426,500
85,94,86,84,97,446,446,500
86,81,98,81,84,430,430,500
86,83,90,95,92,446,446,500
96,84,98,91,96,465,465,500
95,82,81,97,99,454,454,500
86,89,98,86,82,441,441,500
84,82,80,94,81,421,421,500
95,95,91,80,95,456,456,500
86,98,93,95,80,452,452,500
97,87,91,89,98,462,462,500
99,93,88,87,91,458,458,500
84,83,99,81,99,446,446,500
92,87,92,86,88,445,445,500
94,83,84,91,83,435,435,500
83,99,87,98,96,463,463,500
93,94,98,85,82,452,452,500
91,83,82,99,86,441,441,500
98,98,94,80,83,453,453,500
97,87,98,98,98,478,478,500
97,97,91,90,88,463,463,500
91,87,81,84,89,432,432,500
87,84,84,95,90,440,440,500
85,83,99,83,90,440,440,500
90,81,85,83,88,427,427,500
93,83,81,99,96,452,452,500
91,83,89,90,82,435,435,500
91,82,89,87,98,447,447,500
96,83,95,96,86,456,456,500
89,89,80,80,96,434,434,500
90,95,99,84,90,458,458,500
84,89,83,92,83,431,431,500
85,90,81,93,84,433,433,500
84,94,97,90,82,447,447,500
81,82,86,80,96,425,425,500
95,94,90,90,90,459,459,500
95,84,92,92,96,459,459,500
82,95,98,96,86,457,457,500
80,98,85,89,93,445,445,500
86,87,84,88,90,435,435,500
92,95,89,91,92,459,459,500
85,80,86,92,86,429,429,500
89,91,83,83,85,431,431,500
83,96,99,81,80,439,439,500
92,85,85,88,90,440,440,500
81,90,97,87,94,449,449,500
86,86,90,80,94,436,436,500
98,98,97,80,89,462,462,500
80,94,86,95,97,452,452,500
86,98,89,83,95,451,451,500
86,97,82,85,88,438,438,500
87,84,88,88,90,437,437,500
91,91,80,92,95,449,449,500
86,91,92,86,82,437,437,500
92,95,86,87,92,452,452,500
82,96,98,93,80,449,449,500
85,97,91,81,84,438,438,500
81,93,99,88,83,444,444,500
99,99,89,81,87,455,455,500
95,82,89,81,92,439,439,500
99,84,94,99,94,470,470,500
81,92,87,91,85,436,436,500
80,99,82,96,91,448,448,500
83,82,92,88,85,430,430,500
84,95,83,86,92,440,440,500
85,86,92,93,96,452,452,500
83,87,91,99,91,451,451,500
92,81,95,83,99,450,450,500
90,81,87,96,90,444,444,500
91,84,99,84,97,455,455,500
94,87,84,87,87,439,439,500
82,98,88,90,87,445,445,500
89,99,99,87,92,466,466,500
93,86,81,81,92,433,433,500
96,84,93,98,88,459,459,500
81,99,90,86,88,444,444,500
98,82,83,86,93,442,442,500
90,98,99,88,97,472,472,500
88,83,97,81,92,441,441,500
82,99,84,88,92,445,445,500
80,99,85,99,99,462,462,500
99,96,90,95,82,462,462,500
89,90,91,87,82,439,439,500
90,84,87,98,90,449,449,500
82,93,82,93,82,432,432,500
93,80,98,81,94,446,446,500
84,86,92,93,94,449,449,500
98,95,96,95,92,476,476,500
85,80,87,83,90,425,425,500
83,84,99,82,94,442,442,500
83,86,86,86,87,428,428,500
85,96,86,90,88,445,445,500
95,99,81,83,82,440,440,500
96,95,86,94,89,460,460,500
84,83,96,89,91,443,443,500
84,81,82,92,99,438,438,500
94,95,88,83,95,455,455,500
87,99,94,95,97,472,472,500
86,92,88,96,82,444,444,500
80,83,83,84,89,419,419,500
83,83,99,95,99,459,459,500
86,85,92,84,83,430,430,500
83,95,96,84,95,453,453,500
81,98,97,91,82,449,449,500
96,85,86,98,94,459,459,500
88,92,88,95,84,447,447,500
83,93,81,98,80,435,435,500
96,96,84,86,94,456,456,500
92,95,85,93,92,457,457,500
80,93,85,94,90,442,442,500
96,90,90,97,93,466,466,500
87,98,98,80,86,449,449,500
90,89,83,90,94,446,446,500
84,97,92,94,81,448,448,500
84,93,82,91,82,432,432,500
98,82,99,96,97,472,472,500
83,80,98,91,94,446,446,500
83,83,80,82,80,408,408,500
92,96,98,98,80,464,464,500
81,93,91,83,87,435,435,500
96,82,92,88,84,442,442,500
99,93,84,84,95,455,455,500
88,89,92,84,82,435,435,500
82,83,95,85,89,434,434,500
94,95,92,87,81,449,449,500
84,96,87,86,80,433,433,500
82,80,88,85,90,425,425,500
98,92,80,80,84,434,434,500
85,89,87,89,86,436,436,500
94,89,94,90,91,458,458,500
89,86,85,99,81,440,440,500
88,99,87,86,97,457,457,500
93,81,88,94,97,453,453,500
83,89,87,93,81,433,433,500
90,97,96,84,96,463,463,500
83,86,93,89,86,437,437,500
96,86,98,96,82,458,458,500
90,97,84,89,99,459,459,500
90,98,99,88,96,471,471,500
80,95,88,88,81,432,432,500
90,92,85,93,95,455,455,500
97,85,85,94,97,458,458,500
87,99,95,83,91,455,455,500
93,80,98,82,86,439,439,500
90,80,84,89,94,437,437,500
98,83,90,95,97,463,463,500
83,97,88,97,93,458,458,500
81,80,88,88,87,424,424,500
80,94,85,81,98,438,438,500
91,88,90,88,85,442,442,500
95,94,82,86,99,456,456,500
82,87,86,92,98,445,445,500
91,99,89,90,92,461,461,500
94,80,92,92,94,452,452,500
93,96,83,89,81,442,442,500
97,84,97,87,97,462,462,500
97,97,96,97,99,486,486,500
96,87,87,97,84,451,451,500
91,82,84,90,96,443,443,500
98,84,98,83,91,454,454,500
85,80,97,92,84,438,438,500
85,94,83,99,87,448,448,500
83,86,94,95,86,444,444,500
81,88,94,88,90,441,441,500
99,84,97,88,92,460,460,500
92,94,90,85,82,443,443,500
95,98,97,81,97,468,468,500
95,90,93,98,81,457,457,500
98,89,83,80,88,438,438,500
82,98,92,83,84,439,439,500
97,96,86,99,85,463,463,500
81,89,92,87,99,448,448,500
80,87,89,88,81,425,425,500
99,80,93,93,94,459,459,500
95,98,82,96,89,460,460,500
89,87,96,95,92,459,459,500
83,88,91,99,98,459,459,500
82,91,84,81,91,429,429,500
86,85,87,96,89,443,443,500
94,91,85,90,86,446,446,500
80,93,85,83,87,428,428,500
93,89,83,86,97,448,448,500
91,96,96,88,97,468,468,500
85,95,82,98,83,443,443,500
88,98,81,86,82,435,435,500
86,91,97,80,98,452,452,500
80,89,99,80,95,443,443,500
93,81,80,83,92,429,429,500
80,96,90,93,82,441,441,500
95,84,82,83,81,425,425,500
98,92,97,92,92,471,471,500
81,96,90,84,92,443,443,500
89,84,93,84,81,431,431,500
87,89,87,98,90,451,451,500
93,83,85,82,95,438,438,500
98,99,86,96,89,468,468,500
81,82,90,89,99,441,441,500
84,92,87,87,98,448,448,500
92,89,89,87,94,451,451,500
88,97,93,92,89,459,459,500
96,83,90,91,99,459,459,500
93,90,80,91,85,439,439,500
96,84,94,90,87,451,451,500
83,96,97,98,93,467,467,500
97,95,85,99,86,462,462,500
83,95,89,96,97,460,460,500
93,98,97,97,90,475,475,500
94,99,98,99,83,473,473,500
82,83,94,95,90,444,444,500
87,97,90,91,85,450,450,500
97,90,88,83,90,448,448,500
92,88,82,88,89,439,439,500
83,88,80,99,83,433,433,500
99,97,88,87,96,467,467,500
85,97,82,81,98,443,443,500
87,91,80,95,83,436,436,500
87,93,97,80,96,453,453,500
94,88,97,99,90,468,468,500
94,99,89,92,80,454,454,500
83,89,98,89,98,457,457,500
94,82,90,90,83,439,439,500
87,88,81,82,96,434,434,500
90,92,95,92,93,462,462,500
95,87,89,86,97,454,454,500
80,85,85,93,89,432,432,500
99,86,88,88,93,454,454,500
86,85,92,93,89,445,445,500
82,83,94,85,92,436,436,500
97,90,81,90,98,456,456,500
97,90,87,92,80,446,446,500
97,90,96,97,80,460,460,500
89,87,98,88,93,455,455,500
86,99,83,93,86,447,447,500
97,95,93,88,88,461,461,500
96,92,86,90,88,452,452,500
81,98,89,97,95,460,460,500
85,90,81,88,91,435,435,500
90,92,82,87,81,432,432,500
86,89,99,96,99,469,469,500
90,93,87,94,86,450,450,500
89,96,90,82,96,453,453,500
80,85,87,80,93,425,425,500
86,85,99,88,91,449,449,500
83,81,82,90,92,428,428,500
80,85,95,85,86,431,431,500
97,88,97,99,81,462,462,500
85,84,89,92,83,433,433,500
80,81,86,84,99,430,430,500
94,99,94,88,93,468,468,500
88,98,99,99,81,465,465,500
93,95,94,80,92,454,454,500
81,84,96,93,93,447,447,500
98,97,86,94,84,459,459,500
86,87,86,89,82,430,430,500
85,95,91,82,96,449,449,500
88,82,91,80,89,430,430,500
95,94,81,97,86,453,453,500
84,89,95,91,99,458,458,500
87,94,94,87,86,448,448,500
87,86,85,93,82,433,433,500
98,87,83,90,96,454,454,500
83,95,81,95,96,450,450,500
90,95,89,87,93,454,454,500
93,83,97,89,87,449,449,500
85,91,95,95,81,447,447,500
87,98,97,86,94,462,462,500
96,91,88,96,96,467,467,500
97,87,92,85,95,456,456,500
90,84,98,87,89,448,448,500
94,92,96,92,91,465,465,500
98,81,80,86,85,430,430,500
82,95,85,92,92,446,446,500
97,80,92,89,98,456,456,500
90,91,99,85,80,445,445,500
82,92,86,93,92,445,445,500
80,80,89,96,82,427,427,500
80,92,85,86,93,436,436,500
81,83,96,88,98,446,446,500
85,88,96,87,94,450,450,500
81,89,89,99,92,450,450,500
87,91,92,89,82,441,441,500
80,80,91,91,87,429,429,500
95,93,99,85,96,468,468,500
84,89,88,80,97,438,438,500
98,88,89,86,80,441,441,500
83,88,90,97,90,448,448,500
82,88,82,93,87,432,432,500
91,86,89,99,96,461,461,500
90,99,95,90,96,470,470,500
87,91,83,89,91,441,441,500
83,93,93,99,94,462,462,500
85,85,80,98,89,437,437,500
85,81,93,85,81,425,425,500
87,94,97,83,84,445,445,500
84,93,93,87,93,450,450,500
88,83,88,95,82,436,436,500
99,85,91,93,98,466,466,500
96,81,86,84,82,429,429,500
99,99,92,95,99,484,484,500
88,94,93,89,90,454,454,500
88,94,92,80,97,451,451,500
94,82,81,89,92,438,438,500
94,97,93,82,90,456,456,500
95,87,93,83,93,451,451,500
97,97,96,82,82,454,454,500
88,83,87,83,87,428,428,500
88,98,86,98,99,469,469,500
83,80,95,92,95,445,445,500
84,86,80,98,91,439,439,500
96,99,89,90,82,456,456,500
97,94,97,99,82,469,469,500
93,82,98,93,98,464,464,500
83,88,83,86,96,436,436,500
86,95,95,97,96,469,469,500
88,99,80,96,94,457,457,500
87,84,85,91,98,445,445,500
86,82,97,96,91,452,452,500
97,91,91,89,89,457,457,500
99,80,99,96,86,460,460,500
81,83,85,83,95,427,427,500
90,86,81,90,88,435,435,500
81,80,95,83,91,430,430,500
96,84,97,89,90,456,456,500
91,85,90,80,94,440,440,500
87,81,80,83,82,413,413,500
88,83,91,99,85,446,446,500
82,98,98,93,86,457,457,500
96,83,84,94,96,453,453,500
86,96,97,82,96,457,457,500
85,96,85,98,81,445,445,500
82,98,84,96,97,457,457,500
85,91,91,97,90,454,454,500
81,86,89,99,94,449,449,500
86,89,97,81,85,438,438,500
91,83,88,91,91,444,444,500
92,92,87,96,86,453,453,500
98,86,85,94,84,447,447,500
96,92,98,87,80,453,453,500
89,96,94,80,92,451,451,500
94,87,90,95,94,460,460,500
99,88,87,91,83,448,448,500
89,93,86,98,94,460,460,500
84,92,95,86,83,440,440,500
87,96,94,81,82,440,440,500
94,82,96,86,80,438,438,500
91,85,92,80,81,429,429,500
98,81,84,92,81,436,436,500
87,96,81,95,99,458,458,500
99,87,99,80,82,447,447,500
98,83,82,88,94,445,445,500
84,98,87,89,81,439,439,500
83,88,84,85,95,435,435,500
88,86,90,90,90,444,444,500
80,85,85,89,83,422,422,500
94,96,85,84,92,451,451,500
90,91,83,93,91,448,448,500
81,92,99,86,92,450,450,500
94,90,83,81,87,435,435,500
96,97,86,82,87,448,448,500
82,82,96,87,96,443,443,500
85,91,84,95,88,443,443,500
99,81,95,84,81,440,440,500
83,89,85,98,96,451,451,500
95,94,94,98,81,462,462,500
93,97,89,97,99,475,475,500
90,87,99,88,89,453,453,500
90,88,89,99,89,455,455,500
94,82,98,85,94,453,453,500
86,91,96,92,95,460,460,500
93,94,94,94,83,458,458,500
96,99,97,82,83,457,457,500
82,96,95,89,80,442,442,500
87,80,81,93,82,423,423,500
94,84,92,98,87,455,455,500
95,97,92,88,84,456,456,500
80,86,88,88,84,426,426,500
97,97,84,99,87,464,464,500
95,92,96,90,81,454,454,500
89,92,93,92,93,459,459,500
95,85,98,80,85,443,443,500
89,89,93,88,97,456,456,500
93,95,87,93,97,465,465,500
87,90,82,96,93,448,448,500
94,94,83,93,88,452,452,500
89,91,92,92,85,449,449,500
85,95,98,95,93,466,466,500
99,80,83,99,85,446,446,500
81,95,96,86,80,438,438,500
82,81,86,91,86,426,426,500
93,95,98,90,89,465,465,500
93,88,91,99,90,461,461,500
91,81,95,88,94,449,449,500
97,86,88,95,81,447,447,500
95,99,81,99,95,469,469,500
80,95,99,97,94,465,465,500
94,98,91,83,97,463,463,500
87,99,93,83,85,447,447,500
96,96,80,91,93,456,456,500
85,90,95,88,86,444,444,500
83,89,88,81,92,433,433,500
83,89,89,95,96,452,452,500
89,86,88,84,82,429,429,500
81,89,96,98,81,445,445,500
96,80,98,96,84,454,454,500
91,89,85,90,91,446,446,500
82,82,85,84,83,416,416,500
83,86,86,87,99,441,441,500
81,96,83,87,81,428,428,500
84,99,94,83,85,445,445,500
88,87,80,98,95,448,448,500
96,91,84,91,80,442,442,500
82,88,82,83,83,418,418,500
91,81,96,86,95,449,449,500
91,96,86,86,93,452,452,500
85,86,92,94,81,438,438,500
98,96,84,95,85,458,458,500
93,82,90,99,92,456,456,500
83,89,89,80,91,432,432,500
88,91,89,83,99,450,450,500
86,87,91,83,99,446,446,500
93,92,94,81,98,458,458,500
84,94,81,92,89,440,440,500
84,96,95,91,87,453,453,500
93,83,92,99,83,450,450,500
89,80,91,94,99,453,453,500
90,99,99,89,89,466,466,500
82,91,81,89,83,426,426,500
81,87,87,93,89,437,437,500
81,81,81,87,93,423,423,500
87,94,84,83,81,429,429,500
84,93,89,81,80,427,427,500
96,87,93,91,88,455,455,500
95,97,97,97,81,467,467,500
80,86,86,93,96,441,441,500
86,93,80,89,90,438,438,500
87,99,91,88,93,458,458,500
89,98,95,80,86,448,448,500
95,86,95,81,90,447,447,500
81,93,83,92,96,445,445,500
85,95,90,97,81,448,448,500
80,87,86,83,89,425,425,500
86,93,92,95,97,463,463,500
85,98,82,95,99,459,459,500
95,92,83,97,88,455,455,500
91,89,86,87,86,439,439,500
82,92,91,88,94,447,447,500
99,89,95,99,90,472,472,500
98,94,96,82,89,459,459,500
84,97,84,95,84,444,444,500
87,89,85,97,80,438,438,500
91,88,82,84,86,431,431,500
85,85,87,99,87,443,443,500
97,93,80,99,91,460,460,500
84,93,90,86,88,441,441,500
91,98,83,92,87,451,451,500
96,83,83,87,88,437,437,500
86,94,89,82,91,442,442,500
84,82,89,97,87,439,439,500
94,99,96,91,92,472,472,500
90,91,84,83,87,435,435,500
82,89,83,99,83,436,436,500
82,84,88,81,89,424,424,500
81,99,80,83,91,434,434,500
86,94,80,92,90,442,442,500
90,97,94,91,81,453,453,500
89,96,82,91,81,439,439,500
99,82,85,89,94,449,449,500
92,96,91,93,84,456,456,500
90,97,99,81,95,462,462,500
97,89,87,92,95,460,460,500
84,95,96,90,90,455,455,500
82,87,98,98,86,451,451,500
96,84,85,81,80,426,426,500
87,88,92,80,85,432,432,500
86,86,80,82,84,418,418,500
89,93,80,82,84,428,428,500
98,95,84,83,96,456,456,500
95,96,94,95,87,467,467,500
98,95,88,92,84,457,457,500
94,94,92,83,99,462,462,500
82,95,91,95,93,456,456,500
91,84,97,83,86,441,441,500
91,87,94,80,92,444,444,500
82,95,92,81,91,441,441,500
81,94,97,85,98,455,455,500
89,96,80,96,97,458,458,500
83,83,83,95,84,428,428,500
88,90,80,94,85,437,437,500
91,91,85,97,86,450,450,500
97,98,88,93,84,460,460,500
96,81,93,98,82,450,450,500
81,85,86,80,83,415,415,500
92,97,96,94,87,466,466,500
80,89,85,92,89,435,435,500
84,99,97,94,87,461,461,500
98,85,83,90,88,444,444,500
81,95,98,82,97,453,453,500
87,99,97,86,87,456,456,500
80,80,95,97,96,448,448,500
97,96,88,97,87,465,465,500
96,98,93,86,89,462,462,500
81,82,96,83,88,430,430,500
86,95,84,85,97,447,447,500
84,82,80,82,98,426,426,500
97,80,98,94,90,459,459,500
96,87,95,90,91,459,459,500
88,98,99,85,97,467,467,500
81,84,95,91,90,441,441,500
93,98,81,85,81,438,438,500
98,87,80,90,99,454,454,500
92,81,81,99,81,434,434,500
93,81,91,94,92,451,451,500
83,93,94,96,94,460,460,500
99,95,87,80,92,453,453,500
96,86,80,97,85,444,444,500
86,91,89,95,95,456,456,500
98,91,84,93,94,460,460,500
92,85,94,84,85,440,440,500
98,81,91,92,92,454,454,500
82,84,86,89,86,427,427,500
98,98,81,80,95,452,452,500
81,84,95,98,88,446,446,500
88,84,86,97,85,440,440,500
85,97,89,86,85,442,442,500
87,89,97,83,96,452,452,500
89,94,89,90,90,452,452,500
88,83,96,87,96,450,450,500
97,81,99,84,84,445,445,500
81,94,85,92,83,435,435,500
84,85,99,92,97,457,457,500
86,82,96,92,82,438,438,500
97,97,85,87,94,460,460,500
86,80,84,94,92,436,436,500
95,85,84,84,89,437,437,500
98,96,96,88,97,475,475,500
98,94,96,88,99,475,475,500
92,93,81,83,90,439,439,500
92,90,93,84,86,445,445,500
95,83,86,98,90,452,452,500
86,95,84,97,90,452,452,500
92,89,85,82,85,433,433,500
89,81,95,93,86,444,444,500
80,85,82,96,99,442,442,500
85,91,92,93,91,452,452,500
84,95,93,82,80,434,434,500
91,91,85,87,85,439,439,500
86,95,89,83,95,448,448,500
80,92,96,89,88,445,445,500
80,99,82,92,99,452,452,500
91,85,89,92,92,449,449,500
81,99,81,87,89,437,437,500
86,85,85,89,89,434,434,500
84,91,84,92,82,433,433,500
84,97,97,83,94,455,455,500
87,85,98,92,95,457,457,500
82,95,84,81,98,440,440,500
81,99,94,89,90,453,453,500
80,91,94,92,91,448,448,500
89,86,87,89,87,438,438,500
99,81,82,98,87,447,447,500
97,93,90,97,81,458,458,500
87,95,95,91,88,456,456,500
92,98,86,88,86,450,450,500
99,83,93,85,98,458,458,500
95,85,99,97,88,464,464,500
91,81,87,95,80,434,434,500
97,92,89,83,83,444,444,500
97,91,98,98,94,478,478,500
87,83,94,95,84,443,443,500
84,93,98,88,82,445,445,500
96,85,84,89,92,446,446,500
84,86,96,99,81,446,446,500
84,84,83,81,92,424,424,500
91,84,84,84,83,426,426,500
97,80,82,93,91,443,443,500
82,86,85,97,94,444,444,500
91,95,92,89,82,449,449,500
93,95,87,97,86,458,458,500
83,84,94,98,82,441,441,500
92,93,90,94,81,450,450,500
86,88,86,85,84,429,429,500
85,95,82,96,90,448,448,500
82,87,94,92,88,443,443,500
88,89,82,82,94,435,435,500
80,81,80,90,99,430,430,500
91,86,87,80,87,431,431,500
99,96,96,95,92,478,478,500
93,81,86,82,83,425,425,500
93,89,87,85,90,444,444,500
91,94,90,94,91,460,460,500
94,84,85,94,88,445,445,500
94,81,99,89,86,449,449,500
80,89,81,93,83,426,426,500
90,83,94,99,81,447,447,500
92,83,96,85,97,453,453,500
95,95,89,81,91,451,451,500
98,82,80,92,80,432,432,500
92,82,92,84,91,441,441,500
85,88,97,84,84,438,438,500
89,86,85,93,86,439,439,500
82,97,83,80,98,440,440,500
93,91,82,83,87,436,436,500
97,93,90,89,93,462,462,500
81,92,80,80,93,426,426,500
89,83,94,97,98,461,461,500
87,94,90,84,99,454,454,500
95,93,93,89,83,453,453,500
83,96,89,91,94,453,453,500
81,92,96,94,84,447,447,500
84,93,88,80,89,434,434,500
92,87,92,85,84,440,440,500
88,96,99,81,82,446,446,500
88,88,99,84,84,443,443,500
83,95,91,85,98,452,452,500
95,95,96,82,83,451,451,500
93,84,98,84,88,447,447,500
87,97,86,91,98,459,459,500
82,86,91,97,88,444,444,500
87,91,82,86,84,430,430,500
88,96,86,98,91,459,459,500
85,98,87,90,91,451,451,500
92,99,94,88,89,462,462,500
83,86,87,82,95,433,433,500
83,80,90,95,98,446,446,500
96,97,92,90,84,459,459,500
98,94,93,81,92,458,458,500
91,81,93,98,90,453,453,500
93,93,97,80,85,448,448,500
92,86,94,93,89,454,454,500
81,88,99,94,87,449,449,500
90,87,86,95,88,446,446,500
90,90,85,99,85,449,449,500
86,91,87,82,84,430,430,500
84,91,95,95,93,458,458,500
85,92,83,94,95,449,449,500
91,92,96,87,85,451,451,500
99,99,86,85,84,453,453,500
94,82,99,93,82,450,450,500
86,80,84,84,95,429,429,500
86,99,86,93,85,449,449,500
84,88,90,96,97,455,455,500
88,99,89,89,87,452,452,500
84,94,98,81,92,449,449,500
86,90,87,80,97,440,440,500
80,90,89,93,96,448,448,500
88,86,89,92,84,439,439,500
82,81,84,88,93,428,428,500
95,98,94,91,81,459,459,500
92,83,88,85,92,440,440,500
82,84,89,99,87,441,441,500
83,86,82,82,94,427,427,500
83,80,80,85,81,409,409,500
85,92,84,93,80,434,434,500
86,83,94,83,84,430,430,500
90,85,85,81,99,440,440,500
83,91,96,98,86,454,454,500
80,81,93,82,86,422,422,500
97,81,88,81,94,441,441,500
91,92,92,90,85,450,450,500
81,96,84,80,87,428,428,500
95,95,88,93,88,459,459,500
88,93,96,98,82,457,457,500
95,93,99,86,94,467,467,500
81,99,93,99,89,461,461,500
93,98,81,84,95,451,451,500
90,88,99,85,93,455,455,500
90,98,94,88,94,464,464,500
96,90,86,83,88,443,443,500
91,90,86,84,80,431,431,500
98,98,82,80,80,438,438,500
91,99,97,82,97,466,466,500
85,97,88,96,93,459,459,500
90,97,81,85,86,439,439,500
88,82,94,80,98,442,442,500
90,93,84,93,88,448,448,500
94,93,82,89,97,455,455,500
91,83,81,96,89,440,440,500
83,98,80,83,88,432,432,500
99,80,82,90,94,445,445,500
94,81,83,91,98,447,447,500
85,87,85,99,86,442,442,500
99,91,84,93,81,448,448,500
94,95,85,84,95,453,453,500
93,88,80,96,98,455,455,500
97,97,81,81,97,453,453,500
94,90,82,85,98,449,449,500
81,93,84,80,99,437,437,500
82,81,95,80,94,432,432,500
90,80,81,94,91,436,436,500
87,93,97,94,86,457,457,500
84,89,81,84,87,425,425,500
83,94,86,98,80,441,441,500
97,94,98,86,84,459,459,500
92,89,84,93,83,441,441,500
83,82,91,89,92,437,437,500
80,98,90,91,97,456,456,500
95,85,98,93,86,457,457,500
81,85,93,98,82,439,439,500
88,85,85,80,83,421,421,500
92,99,84,92,82,449,449,500
94,93,87,91,85,450,450,500
98,85,85,81,95,444,444,500
81,91,81,87,88,428,428,500
82,93,96,86,96,453,453,500
98,88,90,85,94,455,455,500
83,94,96,83,85,441,441,500
81,82,84,85,81,413,413,500
98,84,91,83,98,454,454,500
83,93,87,94,83,440,440,500
94,89,96,80,99,458,458,500
95,93,85,86,96,455,455,500
97,82,82,82,94,437,437,500
88,99,97,84,86,454,454,500
96,96,86,95,96,469,469,500
91,99,89,83,87,449,449,500
91,87,87,93,89,447,447,500
83,87,87,90,97,444,444,500
91,86,85,83,89,434,434,500
99,80,89,90,86,444,444,500
93,98,89,83,99,462,462,500
89,93,82,84,91,439,439,500
97,98,81,92,92,460,460,500
88,81,86,82,85,422,422,500
83,84,89,85,85,426,426,500
83,97,84,90,88,442,442,500
85,92,86,85,92,440,440,500
87,93,83,82,97,442,442,500
99,94,97,84,90,464,464,500
95,96,91,90,95,467,467,500
82,97,92,93,81,445,445,500
84,93,82,88,88,435,435,500
90,97,82,86,86,441,441,500
80,83,90,83,99,435,435,500
89,93,81,81,96,440,440,500
89,91,90,87,90,447,447,500
89,88,99,98,91,465,465,500
84,82,80,94,90,430,430,500
80,81,80,97,99,437,437,500
91,84,94,82,82,433,433,500
92,92,84,84,97,449,449,500
99,94,92,84,89,458,458,500
85,87,88,86,87,433,433,500
82,88,86,92,99,447,447,500
89,95,82,87,99,452,452,500
92,88,81,97,91,449,449,500
99,94,95,95,87,470,470,500
91,91,98,96,99,475,475,500
83,80,81,90,99,433,433,500
96,93,97,85,96,467,467,500
90,88,87,81,90,436,436,500
88,98,97,89,94,466,466,500
81,85,99,88,86,439,439,500
82,96,89,81,96,444,444,500
94,87,89,89,80,439,439,500
88,94,87,95,83,447,447,500
83,92,94,86,92,447,447,500
85,92,93,87,84,441,441,500
98,94,92,90,87,461,461,500
98,84,82,90,91,445,445,500
83,97,84,88,94,446,446,500
86,81,88,94,96,445,445,500
81,86,94,90,98,449,449,500
86,81,81,83,88,419,419,500
92,98,94,89,90,463,463,500
94,83,87,86,90,440,440,500
97,93,81,91,89,451,451,500
93,84,98,96,85,456,456,500
90,94,88,84,95,451,451,500
86,87,88,86,86,433,433,500
95,80,99,82,96,452,452,500
83,93,85,92,86,439,439,500
93,96,80,93,86,448,448,500
83,85,97,90,90,445,445,500
92,93,87,83,96,451,451,500
90,86,83,84,95,438,438,500
91,99,89,90,92,461,461,500
90,90,83,88,97,448,448,500
81,99,97,99,89,465,465,500
88,84,87,97,95,451,451,500
81,82,92,96,82,433,433,500
97,90,81,91,99,458,458,500
80,97,93,82,87,439,439,500
83,85,94,94,89,445,445,500
94,97,99,88,89,467,467,500
96,87,94,92,85,454,454,500
96,83,88,92,92,451,451,500
90,94,85,87,96,452,452,500
89,83,98,82,82,434,434,500
85,87,88,98,87,445,445,500
94,93,86,91,82,446,446,500
91,99,82,91,99,462,462,500
91,95,92,94,97,469,469,500
87,93,81,96,98,455,455,500
96,95,88,87,87,453,453,500
89,83,90,86,99,447,447,500
95,87,84,91,97,454,454,500
89,96,85,82,90,442,442,500
88,92,90,84,98,452,452,500
85,87,90,85,81,428,428,500
88,84,97,85,87,441,441,500
85,80,97,89,91,442,442,500
92,97,91,95,84,459,459,500
89,91,80,85,93,438,438,500
82,87,82,84,99,434,434,500
83,97,83,86,86,435,435,500
93,82,86,87,95,443,443,500
89,95,88,98,92,462,462,500
93,83,91,88,87,442,442,500
82,89,86,82,84,423,423,500
98,94,96,86,97,471,471,500
84,98,92,83,80,437,437,500
80,97,91,96,91,455,455,500
82,87,90,88,96,443,443,500
90,81,86,98,97,452,452,500
88,80,89,98,84,439,439,500
95,87,87,85,88,442,442,500
95,92,89,93,90,459,459,500
93,94,86,80,87,440,440,500
99,98,95,90,91,473,473,500
96,81,95,81,80,433,433,500
88,94,94,82,95,453,453,500
84,92,90,98,96,460,460,500
82,84,82,87,81,416,416,500
84,94,80,92,86,436,436,500
81,81,94,83,85,424,424,500
92,97,88,90,88,455,455,500
96,88,97,97,98,476,476,500
97,89,81,92,92,451,451,500
87,85,84,90,84,430,430,500
95,81,97,85,85,443,443,500
97,98,87,92,87,461,461,500
83,86,97,85,91,442,442,500
82,91,82,90,96,441,441,500
80,82,84,82,82,410,410,500
80,97,91,87,94,449,449,500
84,92,89,93,93,451,451,500
93,90,82,89,91,445,445,500
80,88,98,93,95,454,454,500
83,86,92,82,96,439,439,500
88,95,81,91,99,454,454,500
97,93,99,81,94,464,464,500
98,83,83,95,96,455,455,500
97,86,90,82,97,452,452,500
98,82,98,86,92,456,456,500
82,90,86,89,85,432,432,500
85,94,88,91,97,455,455,500
92,89,85,87,95,448,448,500
85,84,98,84,87,438,438,500
97,87,92,93,93,462,462,500
91,80,91,97,93,452,452,500
94,90,95,93,93,465,465,500
91,97,82,86,87,443,443,500
97,86,94,89,98,464,464,500
97,91,91,93,98,470,470,500
91,86,98,99,80,454,454,500
96,98,85,89,87,455,455,500
97,94,91,95,89,466,466,500
93,89,88,81,97,448,448,500
88,80,97,85,96,446,446,500
86,83,88,84,80,421,421,500
80,98,81,92,92,443,443,500
92,88,97,85,86,448,448,500
81,82,94,94,90,441,441,500
92,98,86,88,92,456,456,500
80,93,85,91,80,429,429,500
98,85,85,93,91,452,452,500
98,89,88,97,92,464,464,500
92,88,90,88,98,456,456,500
95,87,86,89,87,444,444,500
81,84,80,99,85,429,429,500
91,89,87,97,83,447,447,500
92,96,93,99,89,469,469,500
99,97,82,89,94,461,461,500
99,87,97,82,84,449,449,500
98,81,91,91,94,455,455,500
80,83,98,85,83,429,429,500
81,99,88,98,88,454,454,500
97,94,93,82,86,452,452,500
85,99,87,94,97,462,462,500
84,95,89,93,98,459,459,500
87,95,89,87,87,445,445,500
84,97,94,96,95,466,466,500
85,84,90,90,80,429,429,500
94,81,87,91,81,434,434,500
91,84,95,98,83,451,451,500
81,89,98,89,81,438,438,500
89,86,97,80,93,445,445,500
85,84,90,82,97,438,438,500
96,93,80,92,95,456,456,500
81,88,91,96,91,447,447,500
83,93,81,89,82,428,428,500
80,84,81,89,84,418,418,500
99,82,99,97,84,461,461,500
91,90,95,82,92,450,450,500
90,86,86,98,94,454,454,500
95,89,81,88,82,435,435,500
93,90,97,84,92,456,456,500
89,89,81,86,86,431,431,500
91,90,82,93,95,451,451,500
90,86,88,94,95,453,453,500
97,92,92,88,95,464,464,500
93,96,85,95,82,451,451,500
98,96,80,99,92,465,465,500
93,83,85,88,92,441,441,500
94,99,94,88,88,463,463,500
95,86,89,80,84,434,434,500
90,91,87,95,94,457,457,500
97,93,91,88,94,463,463,500
95,89,89,81,93,447,447,500
88,90,96,89,81,444,444,500
98,81,85,95,86,445,445,500
86,86,91,88,83,434,434,500
86,95,89,97,93,460,460,500
95,83,84,91,89,442,442,500
92,85,85,90,91,443,443,500
86,99,90,99,91,465,465,500
91,85,82,80,96,434,434,500
87,84,98,81,86,436,436,500
98,94,93,88,98,471,471,500
81,94,90,93,81,439,439,500
91,82,94,83,83,433,433,500
96,98,91,82,86,453,453,500
94,81,80,81,92,428,428,500
84,97,90,87,95,453,453,500
93,83,80,91,97,444,444,500
89,83,91,93,82,438,438,500
95,91,85,82,94,447,447,500
89,96,94,97,86,462,462,500
90,97,86,82,83,438,438,500
90,81,82,84,96,433,433,500
83,92,86,84,97,442,442,500
88,88,97,86,81,440,440,500
93,94,95,83,96,461,461,500
81,88,99,85,80,433,433,500
87,93,90,80,82,432,432,500
96,99,81,98,81,455,455,500
88,80,89,95,86,438,438,500
87,89,99,88,86,449,449,500
83,95,81,99,96,454,454,500
82,89,81,99,97,448,448,500
94,88,84,92,93,451,451,500
98,85,98,93,84,458,458,500
90,86,89,95,82,442,442,500
89,99,99,90,99,476,476,500
98,89,89,94,80,450,450,500
82,82,93,82,96,435,435,500
85,98,90,88,88,449,449,500
92,96,92,95,85,460,460,500
97,93,98,97,80,465,465,500
95,93,86,85,98,457,457,500
94,86,97,99,92,468,468,500
92,92,97,93,85,459,459,500
92,92,85,82,87,438,438,500
81,90,85,80,94,430,430,500
85,95,98,99,89,466,466,500
80,92,97,83,95,447,447,500
91,92,91,84,97,455,455,500
80,88,95,87,83,433,433,500
83,88,88,83,89,431,431,500
83,87,83,95,88,436,436,500
95,85,97,90,82,449,449,500
86,80,93,88,87,434,434,500
81,97,90,91,93,452,452,500
87,87,86,80,83,423,423,500
96,94,91,96,80,457,457,500
87,95,98,90,81,451,451,500
89,90,83,87,99,448,448,500
95,95,81,99,86,456,456,500
95,93,82,94,91,455,455,500
88,98,91,88,84,449,449,500
83,86,85,96,85,435,435,500
97,85,96,86,91,455,455,500
86,81,81,90,92,430,430,500
97,82,90,91,97,457,457,500
92,97,90,84,88,451,451,500
83,99,86,97,87,452,452,500
85,90,95,98,96,464,464,500
85,81,81,81,83,411,411,500
86,93,97,91,80,447,447,500
87,95,91,87,92,452,452,500
98,82,97,97,89,463,463,500
97,90,92,85,87,451,451,500
87,82,85,94,83,431,431,500
92,83,89,90,94,448,448,500
97,96,80,99,95,467,467,500
93,83,90,99,92,457,457,500
84,81,89,83,95,432,432,500
83,98,95,80,80,436,436,500
97,84,93,91,95,460,460,500
93,82,96,99,83,453,453,500
81,95,92,85,98,451,451,500
82,96,99,92,90,459,459,500
81,95,84,87,95,442,442,500
89,90,91,94,83,447,447,500
98,80,98,84,81,441,441,500
98,90,88,89,82,447,447,500
98,88,86,87,83,442,442,500
90,91,83,96,85,445,445,500
96,93,93,89,95,466,466,500
91,83,81,94,84,433,433,500
85,96,83,94,90,448,448,500
84,80,87,80,85,416,416,500
85,84,90,91,82,432,432,500
80,91,87,89,88,435,435,500
80,87,81,88,83,419,419,500
88,94,81,83,95,441,441,500
86,86,80,93,82,427,427,500
89,80,83,88,86,426,426,500
96,97,98,94,86,471,471,500
98,94,83,86,91,452,452,500
83,90,80,85,94,432,432,500
82,99,96,98,87,462,462,500
99,85,81,91,88,444,444,500
80,82,92,98,88,440,440,500
86,91,99,94,94,464,464,500
93,88,89,93,95,458,458,500
91,86,96,81,98,452,452,500
97,92,94,84,87,454,454,500
88,95,88,81,89,441,441,500
90,80,88,85,81,424,424,500
85,95,81,80,84,425,425,500
80,81,92,94,84,431,431,500
86,85,86,98,87,442,442,500
92,89,96,87,89,453,453,500
83,96,88,93,81,441,441,500
97,85,85,94,89,450,450,500
85,86,92,99,82,444,444,500
90,89,95,87,91,452,452,500
83,99,89,87,88,446,446,500
89,90,86,91,90,446,446,500
95,96,89,84,87,451,451,500
90,96,84,94,94,458,458,500
92,86,90,91,96,455,455,500
95,98,91,94,89,467,467,500
85,86,98,88,88,445,445,500
85,97,91,96,80,449,449,500
81,85,99,97,96,458,458,500
80,97,97,89,97,460,460,500
81,99,94,81,84,439,439,500
84,95,89,87,87,442,442,500
83,81,97,84,93,438,438,500
82,89,89,99,86,445,445,500
92,90,84,94,80,440,440,500
87,93,85,83,92,440,440,500
99,93,99,89,94,474,474,500
96,93,82,84,91,446,446,500
99,86,88,81,95,449,449,500
94,86,92,90,93,455,455,500
98,85,89,94,94,460,460,500
93,94,87,91,94,459,459,500
85,92,94,82,98,451,451,500
93,84,89,84,98,448,448,500
82,97,84,97,81,441,441,500
90,94,86,80,83,433,433,500
87,82,97,91,88,445,445,500
99,80,85,90,93,447,447,500
92,95,96,81,86,450,450,500
80,80,91,83,86,420,420,500
96,80,84,91,95,446,446,500
88,94,81,99,91,453,453,500
83,86,88,82,88,427,427,500
98,95,91,83,93,460,460,500
98,98,80,80,95,451,451,500
88,87,82,81,86,424,424,500
87,89,87,80,80,423,423,500
82,84,86,86,81,419,419,500
86,91,84,98,90,449,449,500
87,97,84,82,89,439,439,500
99,84,97,80,86,446,446,500
87,84,95,87,94,447,447,500
90,84,80,86,80,420,420,500
99,83,80,96,81,439,439,500
94,94,80,99,88,455,455,500
90,83,87,94,95,449,449,500
83,86,89,97,88,443,443,500
97,81,88,95,85,446,446,500
97,84,81,83,95,440,440,500
82,98,92,97,91,460,460,500
89,98,85,84,90,446,446,500
84,82,97,88,96,447,447,500
83,99,91,90,81,444,444,500
91,81,98,82,82,434,434,500
84,82,89,91,99,445,445,500
87,95,97,85,98,462,462,500
83,92,81,94,91,441,441,500
99,89,83,89,94,454,454,500
97,82,83,81,99,442,442,500
93,94,99,87,95,468,468,500
88,96,87,85,89,445,445,500
83,89,83,82,92,429,429,500
84,88,91,82,82,427,427,500
97,80,99,98,89,463,463,500
82,88,84,81,82,417,417,500
87,98,80,80,82,427,427,500
95,86,95,87,86,449,449,500
90,96,97,85,83,451,451,500
83,86,96,94,80,439,439,500
83,83,83,89,87,425,425,500
93,88,86,87,80,434,434,500
84,87,90,90,99,450,450,500
91,91,85,83,88,438,438,500
81,96,97,88,93,455,455,500
83,98,95,95,87,458,458,500
90,91,90,83,86,440,440,500
86,86,98,91,97,458,458,500
89,89,87,85,83,433,433,500
96,85,94,90,97,462,462,500
97,96,85,96,97,471,471,500
98,83,81,85,89,436,436,500
93,97,91,83,81,445,445,500
90,86,92,99,93,460,460,500
88,98,90,94,88,458,458,500
83,84,93,88,81,429,429,500
93,84,86,92,85,440,440,500
97,81,86,93,81,438,438,500
83,95,93,99,87,457,457,500
89,82,86,99,97,453,453,500
81,88,98,86,87,440,440,500
93,97,90,82,83,445,445,500
97,81,96,91,99,464,464,500
97,88,95,93,99,472,472,500
91,98,86,87,93,455,455,500
87,97,82,95,96,457,457,500
95,86,97,86,86,450,450,500
98,80,93,84,86,441,441,500
80,88,94,99,86,447,447,500
85,94,88,95,96,458,458,500
84,96,92,91,97,460,460,500
86,96,83,82,97,444,444,500
90,93,99,91,82,455,455,500
99,91,95,82,85,452,452,500
99,94,94,89,87,463,463,500
80,80,93,93,85,431,431,500
82,93,85,91,88,439,439,500
82,91,97,97,99,466,466,500
97,96,94,82,92,461,461,500
94,97,89,95,86,461,461,500
94,99,96,86,85,460,460,500
89,96,91,87,89,452,452,500
83,89,97,85,91,445,445,500
89,85,80,86,81,421,421,500
93,98,99,91,93,474,474,500
92,87,80,88,91,438,438,500
88,94,98,86,99,465,465,500
84,92,84,83,86,429,429,500
95,95,90,86,95,461,461,500
90,98,86,95,86,455,455,500
87,80,92,95,85,439,439,500
96,94,90,93,96,469,469,500
83,99,82,94,86,444,444,500
93,99,97,91,97,477,477,500
90,86,81,94,88,439,439,500
88,82,85,86,92,433,433,500
98,90,90,90,96,464,464,500
82,90,86,81,82,421,421,500
90,98,93,85,82,448,448,500
95,91,82,91,95,454,454,500
82,88,97,99,85,451,451,500
81,84,85,88,91,429,429,500
97,95,98,99,83,472,472,500
95,97,91,83,90,456,456,500
83,99,89,95,82,448,448,500
85,80,81,84,82,412,412,500
93,95,91,97,93,469,469,500
80,97,95,92,89,453,453,500
92,96,99,96,91,474,474,500
86,80,95,88,98,447,447,500
80,88,97,80,97,442,442,500
85,91,84,82,86,428,428,500
89,82,85,88,95,439,439,500
83,93,97,95,88,456,456,500
81,82,82,97,82,424,424,500
91,94,86,84,97,452,452,500
96,91,96,84,91,458,458,500
93,95,89,83,98,458,458,500
82,96,83,96,94,451,451,500
90,85,82,81,86,424,424,500
87,91,85,98,81,442,442,500
99,83,81,97,93,453,453,500
95,89,93,88,82,447,447,500
96,93,92,85,86,452,452,500
92,93,84,96,83,448,448,500
95,87,81,99,88,450,450,500
85,81,89,82,82,419,419,500
82,94,89,99,98,462,462,500
90,98,90,92,92,462,462,500
89,84,91,91,85,440,440,500
98,83,97,89,91,458,458,500
98,81,87,82,97,445,445,500
83,83,88,85,89,428,428,500
91,86,98,85,86,446,446,500
84,80,94,98,90,446,446,500
96,87,84,96,92,455,455,500
94,86,89,84,97,450,450,500
85,83,82,98,89,437,437,500
93,86,92,84,92,447,447,500
86,89,81,80,90,426,426,500
82,95,98,96,80,451,451,500
95,83,81,92,98,449,449,500
82,86,86,95,80,429,429,500
94,85,97,96,99,471,471,500
81,90,82,87,81,421,421,500
80,84,89,95,86,434,434,500
82,90,95,92,85,444,444,500
81,84,94,90,88,437,437,500
89,83,97,80,81,430,430,500
98,81,91,86,95,451,451,500
84,89,90,83,97,443,443,500
82,86,92,83,95,438,438,500
89,85,95,97,98,464,464,500
97,96,92,82,86,453,453,500
91,82,83,80,93,429,429,500
99,90,98,87,96,470,470,500
84,88,86,83,81,422,422,500
95,88,80,87,92,442,442,500
88,93,83,83,91,438,438,500
84,81,80,82,85,412,412,500
87,87,84,98,93,449,449,500
96,99,87,86,84,452,452,500
94,88,94,96,87,459,459,500
92,85,87,95,83,442,442,500
98,89,82,97,94,460,460,500
98,95,83,80,97,453,453,500
98,94,89,81,81,443,443,500
87,99,84,95,94,459,459,500
91,97,99,82,98,467,467,500
96,83,91,94,89,453,453,500
96,96,83,93,94,462,462,500
82,83,91,82,89,427,427,500
94,87,86,83,91,441,441,500
88,90,96,80,87,441,441,500
99,97,89,88,96,469,469,500
89,83,90,99,99,460,460,500
98,87,96,96,89,466,466,500
86,93,85,90,83,437,437,500
83,99,85,98,91,456,456,500
97,83,80,97,85,442,442,500
98,89,94,81,86,448,448,500
84,83,84,86,83,420,420,500
88,96,96,89,84,453,453,500
89,95,93,86,98,461,461,500
99,97,86,94,87,463,463,500
89,96,95,95,94,469,469,500
90,99,89,98,88,464,464,500
88,90,83,86,80,427,427,500
85,97,95,81,83,441,441,500
89,84,87,88,82,430,430,500
90,99,92,81,97,459,459,500
85,93,82,82,89,431,431,500
98,95,85,83,92,453,453,500
88,87,92,92,90,449,449,500
82,89,81,86,91,429,429,500
86,87,85,97,85,440,440,500
96,80,83,91,95,445,445,500
85,87,93,93,87,445,445,500
84,88,82,82,85,421,421,500
98,84,84,88,98,452,452,500
89,95,94,82,80,440,440,500
99,96,96,97,97,485,485,500
91,98,98,86,92,465,465,500
96,84,84,92,80,436,436,500
91,99,82,90,95,457,457,500
98,88,99,93,81,459,459,500
95,84,94,82,86,441,441,500
99,86,81,87,85,438,438,500
86,92,95,97,87,457,457,500
84,91,96,92,82,445,445,500
97,80,94,81,90,442,442,500
85,99,82,93,97,456,456,500
93,94,87,97,99,470,470,500
87,99,83,90,80,439,439,500
92,94,91,91,81,449,449,500
91,94,86,97,86,454,454,500
89,99,86,99,98,471,471,500
90,98,92,94,81,455,455,500
98,89,92,82,95,456,456,500
89,86,82,98,85,440,440,500
82,85,85,85,96,433,433,500
99,82,92,99,94,466,466,500
83,82,84,92,89,430,430,500
91,95,84,86,87,443,443,500
99,88,84,89,97,457,457,500
89,95,84,85,93,446,446,500
83,95,93,89,92,452,452,500
94,93,98,99,82,466,466,500
95,82,98,82,97,454,454,500
91,92,86,84,97,450,450,500
85,97,82,85,90,439,439,500
83,82,88,82,86,421,421,500
96,90,83,96,87,452,452,500
90,91,93,82,97,453,453,500
90,81,86,82,86,425,425,500
90,92,85,95,81,443,443,500
80,93,80,95,85,433,433,500
81,96,81,81,93,432,432,500
86,80,94,85,82,427,427,500
92,92,97,86,95,462,462,500
81,86,82,86,90,425,425,500
94,84,84,87,85,434,434,500
93,93,83,92,96,457,457,500
84,88,82,85,91,430,430,500
86,98,84,88,94,450,450,500
85,83,96,94,82,440,440,500
83,99,89,88,87,446,446,500
92,97,99,97,84,469,469,500
85,90,82,83,95,435,435,500
85,85,96,80,85,431,431,500
88,85,91,96,83,443,443,500
99,93,94,84,97,467,467,500
87,90,87,80,80,424,424,500
90,93,97,86,81,447,447,500
80,90,81,94,94,439,439,500
85,84,90,88,99,446,446,500
92,93,98,84,86,453,453,500
93,81,96,90,93,453,453,500
92,97,99,91,88,467,467,500
85,87,93,89,99,453,453,500
90,82,84,85,89,430,430,500
90,83,99,85,91,448,448,500
82,82,86,98,96,444,444,500
99,81,97,89,84,450,450,500
93,94,84,95,99,465,465,500
91,87,81,88,84,431,431,500
90,85,94,99,94,462,462,500
89,89,96,86,99,459,459,500
88,89,86,94,93,450,450,500
93,90,82,94,80,439,439,500
84,96,92,97,86,455,455,500
94,90,83,86,97,450,450,500
90,88,89,92,96,455,455,500
98,91,81,92,91,453,453,500
93,84,87,91,94,449,449,500
92,94,81,93,95,455,455,500
97,99,81,89,80,446,446,500
88,85,82,90,80,425,425,500
89,84,99,84,88,444,444,500
97,85,96,91,98,467,467,500
92,87,83,97,98,457,457,500
87,82,90,94,93,446,446,500
80,85,85,85,86,421,421,500
82,93,80,85,90,430,430,500
88,85,80,88,83,424,424,500
95,99,96,93,89,472,472,500
93,98,96,88,94,469,469,500
83,95,82,85,81,426,426,500
93,90,96,91,97,467,467,500
84,86,94,95,98,457,457,500
86,81,85,95,81,428,428,500
83,86,80,80,99,428,428,500
83,81,85,83,92,424,424,500
94,84,83,84,97,442,442,500
90,88,86,97,85,446,446,500
82,81,95,94,94,446,446,500
81,93,93,88,93,448,448,500
89,80,96,83,81,429,429,500
84,92,81,82,93,432,432,500
94,96,94,81,99,464,464,500
90,98,93,84,98,463,463,500
81,84,86,87,90,428,428,500
98,84,91,87,85,445,445,500
84,94,98,90,95,461,461,500
91,92,99,92,94,468,468,500
86,99,88,96,83,452,452,500
95,96,99,85,96,471,471,500
83,87,99,90,97,456,456,500
80,90,80,90,97,437,437,500
86,93,80,92,86,437,437,500
93,82,92,81,90,438,438,500
89,84,81,90,96,440,440,500
81,83,94,97,85,440,440,500
99,96,82,90,82,449,449,500
99,85,80,98,93,455,455,500
98,82,80,91,95,446,446,500
81,93,80,86,96,436,436,500
82,80,88,89,83,422,422,500
89,89,88,95,83,444,444,500
95,83,87,96,99,460,460,500
84,81,96,84,98,443,443,500
97,95,91,87,85,455,455,500
81,83,97,94,94,449,449,500
87,90,92,85,91,445,445,500
98,93,96,94,83,464,464,500
84,88,94,99,88,453,453,500
95,85,93,98,94,465,465,500
88,96,85,84,82,435,435,500
80,82,87,85,95,429,429,500
87,99,98,99,94,477,477,500
87,97,95,88,92,459,459,500
88,85,89,92,82,436,436,500
95,87,95,88,99,464,464,500
87,87,91,93,92,450,450,500
92,90,88,97,92,459,459,500
88,99,90,83,96,456,456,500
92,85,86,99,93,455,455,500
96,89,95,89,95,464,464,500
83,97,82,84,93,439,439,500
97,92,89,94,95,467,467,500
84,86,88,88,86,432,432,500
85,97,90,85,95,452,452,500
92,96,84,89,92,453,453,500
96,96,93,88,87,460,460,500
94,80,82,88,83,427,427,500
82,99,96,92,88,457,457,500
86,95,99,97,85,462,462,500
98,99,99,81,90,467,467,500
80,87,94,97,96,454,454,500
86,94,86,96,95,457,457,500
87,99,96,93,97,472,472,500
94,99,95,98,96,482,482,500
86,92,80,89,84,431,431,500
91,98,87,84,82,442,442,500
82,92,89,82,84,429,429,500
96,92,81,88,95,452,452,500
82,90,93,83,98,446,446,500
91,90,89,86,89,445,445,500
80,86,87,85,92,430,430,500
99,80,93,93,82,447,447,500
80,90,80,99,80,429,429,500
99,88,93,93,96,469,469,500
88,88,88,92,80,436,436,500
94,85,98,93,83,453,453,500
82,82,83,83,97,427,427,500
98,93,88,81,90,450,450,500
89,94,80,91,81,435,435,500
92,81,95,82,89,439,439,500
91,82,99,96,90,458,458,500
97,97,88,88,97,467,467,500
96,93,85,99,83,456,456,500
94,95,82,82,88,441,441,500
89,83,91,84,96,443,443,500
87,85,82,99,80,433,433,500
84,96,90,96,93,459,459,500
87,84,83,98,93,445,445,500
91,96,95,88,96,466,466,500
99,97,91,97,86,470,470,500
95,86,84,81,82,428,428,500
85,87,88,95,88,443,443,500
84,91,84,95,92,446,446,500
88,93,98,92,90,461,461,500
94,92,81,96,80,443,443,500
98,93,88,96,88,463,463,500
81,90,91,86,80,428,428,500
81,90,86,96,99,452,452,500
93,90,98,99,87,467,467,500
97,94,81,93,90,455,455,500
86,95,99,87,96,463,463,500
83,80,85,97,80,425,425,500
90,91,82,90,97,450,450,500
85,83,84,84,85,421,421,500
91,84,89,89,82,435,435,500
90,81,94,97,80,442,442,500
85,82,93,88,81,429,429,500
83,93,97,94,80,447,447,500
99,84,94,91,91,459,459,500
90,91,81,85,84,431,431,500
85,85,82,94,90,436,436,500
84,81,80,98,93,436,436,500
92,82,87,97,91,449,449,500
84,88,83,95,82,432,432,500
98,82,90,94,83,447,447,500
97,97,93,80,97,464,464,500
82,96,80,98,98,454,454,500
84,89,98,95,84,450,450,500
83,94,89,89,94,449,449,500
93,81,96,96,97,463,463,500
89,95,83,80,85,432,432,500
82,93,82,88,87,432,432,500
86,89,93,83,87,438,438,500
87,83,82,99,82,433,433,500
82,83,98,88,88,439,439,500
94,91,90,96,88,459,459,500
89,93,91,92,87,452,452,500
96,92,88,99,88,463,463,500
90,82,87,87,84,430,430,500
95,99,97,87,95,473,473,500
96,95,95,85,91,462,462,500
95,96,87,92,99,469,469,500
87,89,99,91,81,447,447,500
97,93,92,89,97,468,468,500
82,95,85,84,98,444,444,500
87,90,85,93,92,447,447,500
81,89,89,87,87,433,433,500
98,84,97,91,98,468,468,500
93,89,99,97,89,467,467,500
80,82,84,89,99,434,434,500
83,81,96,83,97,440,440,500
87,97,95,92,84,455,455,500
96,85,90,99,84,454,454,500
85,93,99,81,83,441,441,500
92,94,88,85,96,455,455,500
92,90,97,82,96,457,457,500
81,85,80,88,86,420,420,500
81,87,87,97,89,441,441,500
87,91,93,84,81,436,436,500
90,85,95,85,88,443,443,500
98,92,80,89,95,454,454,500
82,89,95,98,88,452,452,500
99,80,96,90,81,446,446,500
96,87,86,97,95,461,461,500
83,97,99,84,93,456,456,500
81,96,82,98,82,439,439,500
92,83,94,97,80,446,446,500
98,87,95,87,88,455,455,500
99,99,95,86,85,464,464,500
80,99,89,87,85,440,440,500
83,92,90,91,94,450,450,500
87,96,95,82,82,442,442,500
95,80,90,87,89,441,441,500
95,89,94,94,92,464,464,500
82,89,80,89,90,430,430,500
84,92,86,83,91,436,436,500
96,87,85,89,87,444,444,500
92,82,93,83,99,449,449,500
85,82,86,86,93,432,432,500
95,86,85,89,99,454,454,500
85,80,98,98,85,446,446,500
92,88,87,89,91,447,447,500
82,96,86,83,80,427,427,500
89,99,92,92,99,471,471,500
95,96,81,92,83,447,447,500
87,94,95,80,90,446,446,500
97,90,99,88,84,458,458,500
86,98,80,92,86,442,442,500
97,86,85,85,93,446,446,500
80,94,93,90,81,438,438,500
80,80,81,91,92,424,424,500
99,80,82,98,81,440,440,500
82,94,84,82,84,426,426,500
84,82,93,84,94,437,437,500
93,89,86,92,85,445,445,500
95,93,87,90,94,459,459,500
88,90,95,80,90,443,443,500
93,85,90,80,83,431,431,500
91,95,95,85,86,452,452,500
94,94,93,84,99,464,464,500
84,85,82,86,84,421,421,500
99,98,94,86,92,469,469,500
84,98,88,96,91,457,457,500
80,91,99,88,94,452,452,500
86,86,81,94,83,430,430,500
81,96,87,87,80,431,431,500
86,93,92,80,97,448,448,500
86,99,94,95,88,462,462,500
80,86,80,97,92,435,435,500
80,84,95,81,97,437,437,500
94,81,94,97,92,458,458,500
82,89,98,96,97,462,462,500
87,97,90,81,97,452,452,500
89,92,81,98,86,446,446,500
82,87,99,97,87,452,452,500
95,98,95,86,93,467,467,500
94,93,88,85,84,444,444,500
83,92,87,80,91,433,433,500
94,83,88,87,81,433,433,500
92,93,86,88,88,447,447,500
82,89,95,86,95,447,447,500
98,84,89,94,99,464,464,500
85,98,95,96,85,459,459,500
86,92,85,98,81,442,442,500
92,83,81,96,93,445,445,500
93,87,95,95,89,459,459,500
80,88,98,88,87,441,441,500
81,91,81,89,81,423,423,500
88,86,84,82,86,426,426,500
98,96,85,92,89,460,460,500
93,91,85,84,84,437,437,500
91,99,98,83,88,459,459,500
86,95,94,84,87,446,446,500
92,91,98,86,92,459,459,500
86,89,97,93,87,452,452,500
82,90,81,88,93,434,434,500
91,85,96,91,82,445,445,500
81,82,93,97,96,449,449,500
98,86,99,89,83,455,455,500
97,97,98,96,96,484,484,500
96,81,98,98,98,471,471,500
97,96,83,86,96,458,458,500
97,85,93,83,92,450,450,500
94,95,91,95,92,467,467,500
93,85,87,88,90,443,443,500
87,86,90,92,93,448,448,500
89,81,82,83,87,422,422,500
91,83,94,82,98,448,448,500
80,97,96,80,81,434,434,500
88,87,83,93,92,443,443,500
82,89,84,89,89,433,433,500
83,99,98,85,98,463,463,500
86,99,89,99,98,471,471,500
82,80,83,96,83,424,424,500
91,94,87,82,90,444,444,500
81,98,84,94,88,445,445,500
81,99,99,95,97,471,471,500
89,86,99,97,86,457,457,500
91,97,98,96,90,472,472,500
81,98,95,87,84,445,445,500
85,94,83,88,88,438,438,500
97,93,81,83,80,434,434,500
89,84,90,97,91,451,451,500
81,92,82,98,83,436,436,500
90,84,84,89,92,439,439,500
99,94,95,81,85,454,454,500
80,92,83,89,86,430,430,500
90,81,92,96,84,443,443,500
87,87,99,81,83,437,437,500
99,83,80,93,90,445,445,500
95,99,93,93,86,466,466,500
89,93,88,81,97,448,448,500
80,85,82,81,83,411,411,500
94,92,86,81,85,438,438,500
93,83,93,91,80,440,440,500
86,87,86,88,82,429,429,500
93,81,97,93,89,453,453,500
91,93,83,91,97,455,455,500
99,93,83,93,92,460,460,500
97,85,90,96,95,463,463,500
85,90,93,99,82,449,449,500
84,99,93,99,87,462,462,500
99,92,96,85,82,454,454,500
99,96,86,85,86,452,452,500
82,90,97,93,92,454,454,500
97,91,97,84,88,457,457,500
86,90,85,84,93,438,438,500
92,91,81,99,89,452,452,500
83,83,88,87,84,425,425,500
94,97,95,93,93,472,472,500
92,80,96,88,80,436,436,500
84,95,93,91,87,450,450,500
94,88,95,84,85,446,446,500
94,96,87,86,92,455,455,500
89,96,92,85,83,445,445,500
84,95,88,94,97,458,458,500
88,94,87,88,92,449,449,500
97,81,98,84,82,442,442,500
96,85,90,95,97,463,463,500
91,95,82,93,83,444,444,500
84,86,93,95,94,452,452,500
80,87,99,99,98,463,463,500
96,95,87,93,85,456,456,500
84,97,96,82,98,457,457,500
80,98,84,92,98,452,452,500
81,92,80,86,91,430,430,500
96,90,90,98,91,465,465,500
92,89,91,83,88,443,443,500
81,92,85,80,99,437,437,500
89,90,80,88,88,435,435,500
93,98,81,82,80,434,434,500
89,94,93,93,84,453,453,500
82,99,98,80,89,448,448,500
99,90,95,85,98,467,467,500
82,85,85,86,89,427,427,500
98,82,94,92,80,446,446,500
85,99,92,80,98,454,454,500
92,83,98,81,89,443,443,500
84,97,81,84,99,445,445,500
84,99,88,96,97,464,464,500
84,81,86,87,91,429,429,500
84,86,85,86,84,425,425,500
97,83,91,93,92,456,456,500
81,97,85,91,97,451,451,500
98,87,88,95,82,450,450,500
85,82,81,88,90,426,426,500
92,93,94,83,93,455,455,500
82,84,90,94,93,443,443,500
87,91,84,94,81,437,437,500
92,87,96,83,90,448,448,500
96,96,87,87,89,455,455,500
93,86,93,95,97,464,464,500
92,92,85,93,91,453,453,500
92,94,95,82,86,449,449,500
89,99,80,87,97,452,452,500
86,95,96,86,81,444,444,500
80,91,85,91,92,439,439,500
81,99,87,99,94,460,460,500
95,94,82,94,87,452,452,500
95,95,80,83,89,442,442,500
96,88,97,97,84,462,462,500
93,98,81,81,96,449,449,500
99,81,90,99,90,459,459,500
83,94,90,84,89,440,440,500
81,95,95,86,92,449,449,500
87,90,85,92,89,443,443,500
95,81,95,85,89,445,445,500
89,83,81,86,87,426,426,500
85,85,96,89,89,444,444,500
95,85,84,96,81,441,441,500
91,83,82,91,98,445,445,500
96,89,82,98,93,458,458,500
90,86,83,85,85,429,429,500
88,88,91,81,97,445,445,500
85,90,89,92,89,445,445,500
92,88,99,90,91,460,460,500
83,84,85,99,94,445,445,500
97,85,95,80,93,450,450,500
89,95,98,81,99,462,462,500
87,99,93,97,87,463,463,500
85,99,91,94,87,456,456,500
88,97,87,91,99,462,462,500
94,89,93,90,98,464,464,500
86,86,99,89,99,459,459,500
89,93,84,96,91,453,453,500
91,95,90,91,85,452,452,500
92,98,94,81,86,451,451,500
88,91,92,92,84,447,447,500
97,81,95,98,88,459,459,500
91,96,86,98,85,456,456,500
98,91,80,93,96,458,458,500
94,90,95,81,97,457,457,500
97,80,95,96,80,448,448,500
90,96,92,82,86,446,446,500
85,82,83,99,98,447,447,500
86,84,81,91,94,436,436,500
81,98,99,88,95,461,461,500
85,88,97,98,81,449,449,500
83,82,85,98,93,441,441,500
88,92,84,83,92,439,439,500
83,92,81,93,98,447,447,500
97,81,93,88,88,447,447,500
92,87,95,80,80,434,434,500
91,91,94,85,81,442,442,500
91,91,82,83,97,444,444,500
87,91,86,83,96,443,443,500
80,89,98,87,93,447,447,500
99,91,95,91,86,462,462,500
92,84,97,92,98,463,463,500
88,81,81,99,85,434,434,500
88,90,87,92,93,450,450,500
91,94,88,92,85,450,450,500
98,98,89,94,93,472,472,500
99,85,91,90,82,447,447,500
94,89,82,95,92,452,452,500
98,83,87,99,87,454,454,500
91,82,97,94,83,447,447,500
86,88,98,97,87,456,456,500
83,88,90,93,82,436,436,500
87,92,90,92,99,460,460,500
88,91,88,98,86,451,451,500
83,96,89,98,89,455,455,500
90,94,82,83,90,439,439,500
82,94,95,84,94,449,449,500
88,83,97,88,84,440,440,500
98,92,80,88,89,447,447,500
87,98,81,90,89,445,445,500
81,88,80,84,85,418,418,500
83,91,82,92,86,434,434,500
84,91,94,88,85,442,442,500
99,99,97,92,85,472,472,500
87,98,81,91,94,451,451,500
90,95,82,98,81,446,446,500
91,81,84,80,99,435,435,500
89,88,93,83,87,440,440,500
93,92,80,85,84,434,434,500
99,91,82,81,84,437,437,500
92,99,87,87,90,455,455,500
91,95,94,95,89,464,464,500
89,99,93,80,91,452,452,500
93,87,91,93,89,453,453,500
91,83,89,86,85,434,434,500
85,87,96,90,95,453,453,500
90,80,94,84,95,443,443,500
82,91,95,98,92,458,458,500
81,81,96,86,82,426,426,500
81,87,89,90,98,445,445,500
88,97,82,94,93,454,454,500
87,99,91,81,97,455,455,500
94,97,84,89,86,450,450,500
89,80,94,91,80,434,434,500
86,91,95,99,84,455,455,500
88,97,98,97,93,473,473,500
93,84,88,87,95,447,447,500
99,92,98,93,83,465,465,500
99,92,99,95,86,471,471,500
98,86,89,82,89,444,444,500
92,98,95,80,95,460,460,500
96,90,85,92,90,453,453,500
90,84,96,82,90,442,442,500
94,97,94,87,98,470,470,500
82,97,91,94,82,446,446,500
89,84,85,90,84,432,432,500
91,86,88,87,86,438,438,500
94,97,98,96,83,468,468,500
89,92,97,98,86,462,462,500
96,89,97,84,84,450,450,500
80,91,80,83,91,425,425,500
84,81,96,91,89,441,441,500
87,91,98,98,87,461,461,500
80,82,98,81,91,432,432,500
96,96,96,99,88,475,475,500
83,98,93,91,99,464,464,500
82,98,90,87,88,445,445,500
90,80,85,90,87,432,432,500
84,90,82,91,92,439,439,500
87,86,99,80,91,443,443,500
86,97,90,92,90,455,455,500
80,99,80,85,86,430,430,500
94,92,83,90,98,457,457,500
93,81,93,99,97,463,463,500
88,85,92,91,85,441,441,500
87,91,89,87,96,450,450,500
83,80,90,83,97,433,433,500
89,90,90,86,81,436,436,500
95,93,96,84,87,455,455,500
98,84,85,94,97,458,458,500
86,82,93,94,85,440,440,500
93,89,82,99,99,462,462,500
94,89,87,93,97,460,460,500
80,82,91,96,98,447,447,500
94,99,94,80,90,457,457,500
97,96,96,85,86,460,460,500
97,90,92,88,90,457,457,500
82,88,99,96,82,447,447,500
94,91,86,91,84,446,446,500
86,81,98,80,89,434,434,500
88,94,97,90,87,456,456,500
81,89,80,83,83,416,416,500
91,92,82,91,82,438,438,500
81,97,92,92,91,453,453,500
98,81,95,85,94,453,453,500
93,97,94,92,83,459,459,500
99,91,97,87,84,458,458,500
96,86,87,96,86,451,451,500
93,80,91,94,81,439,439,500
96,90,83,88,92,449,449,500
93,86,84,88,89,440,440,500
93,94,85,82,84,438,438,500
90,88,80,85,87,430,430,500
91,88,93,91,84,447,447,500
96,98,84,97,83,458,458,500
83,89,96,97,85,450,450,500
94,85,81,83,89,432,432,500
93,92,83,88,88,444,444,500
86,83,91,99,81,440,440,500
81,85,99,86,81,432,432,500
87,94,90,80,90,441,441,500
98,97,80,85,84,444,444,500
88,90,87,95,90,450,450,500
85,92,97,99,83,456,456,500
93,99,92,82,83,449,449,500
88,97,94,81,85,445,445,500
89,90,88,81,82,430,430,500
87,95,86,93,91,452,452,500
80,94,90,98,83,445,445,500
98,99,85,96,90,468,468,500
94,88,91,93,93,459,459,500
93,85,92,88,88,446,446,500
86,88,99,87,88,448,448,500
88,80,87,96,82,433,433,500
92,80,99,89,91,451,451,500
81,83,94,87,93,438,438,500
92,97,85,85,87,446,446,500
91,83,85,90,88,437,437,500
92,95,81,98,93,459,459,500
83,85,96,82,88,434,434,500
96,93,93,90,89,461,461,500
99,84,82,98,96,459,459,500
94,98,93,85,94,464,464,500
88,90,82,91,87,438,438,500
90,92,86,81,89,438,438,500
95,88,99,88,84,454,454,500
84,99,92,87,88,450,450,500
92,99,95,82,91,459,459,500
90,99,87,85,95,456,456,500
91,98,84,81,89,443,443,500
81,80,85,93,89,428,428,500
90,81,80,97,84,432,432,500
90,96,92,81,94,453,453,500
87,98,84,84,86,439,439,500
80,84,84,87,93,428,428,500
95,88,88,99,97,467,467,500
80,86,80,90,85,421,421,500
94,84,81,97,85,441,441,500
82,97,82,82,92,435,435,500
97,93,94,85,86,455,455,500
82,83,95,93,90,443,443,500
92,89,80,92,81,434,434,500
95,86,84,92,91,448,448,500
98,88,90,90,92,458,458,500
88,90,98,92,89,457,457,500
86,90,86,83,82,427,427,500
98,85,89,84,95,451,451,500
94,95,99,93,99,480,480,500
89,94,96,86,85,450,450,500
90,83,84,91,80,428,428,500
82,85,85,92,87,431,431,500
86,81,93,87,98,445,445,500
93,90,98,81,87,449,449,500
83,81,89,80,83,416,416,500
94,85,89,88,89,445,445,500
92,93,96,87,89,457,457,500
96,93,97,90,85,461,461,500
85,91,80,92,80,428,428,500
92,92,95,98,95,472,472,500
86,83,99,98,99,465,465,500
84,96,96,86,89,451,451,500
93,80,82,92,80,427,427,500
94,82,90,83,82,431,431,500
89,99,81,86,96,451,451,500
91,85,92,96,84,448,448,500
86,87,81,92,85,431,431,500
82,86,82,83,80,413,413,500
83,80,84,94,89,430,430,500
81,80,83,92,86,422,422,500
89,92,99,92,92,464,464,500
84,84,98,90,87,443,443,500
95,84,93,84,92,448,448,500
94,90,85,85,87,441,441,500
81,87,97,83,85,433,433,500
85,90,95,96,86,452,452,500
89,95,97,88,96,465,465,500
80,86,88,93,88,435,435,500
98,90,88,81,87,444,444,500
83,95,88,82,94,442,442,500
90,88,89,97,97,461,461,500
94,98,90,99,98,479,479,500
86,99,90,86,88,449,449,500
95,85,83,96,84,443,443,500
99,90,85,93,90,457,457,500
86,82,98,95,81,442,442,500
92,88,86,96,96,458,458,500
99,84,87,97,94,461,461,500
80,84,80,86,87,417,417,500
88,89,83,95,91,446,446,500
96,86,81,94,82,439,439,500
91,89,97,82,82,441,441,500
93,96,95,91,90,465,465,500
89,84,91,96,88,448,448,500
81,80,83,80,89,413,413,500
96,97,83,80,98,454,454,500
93,94,92,82,87,448,448,500
83,91,93,81,83,431,431,500
81,81,93,90,85,430,430,500
96,89,92,82,90,449,449,500
98,93,80,99,80,450,450,500
87,85,82,89,82,425,425,500
80,92,92,82,95,441,441,500
95,82,96,85,93,451,451,500
99,80,88,91,99,457,457,500
81,93,87,99,94,454,454,500
94,93,86,83,98,454,454,500
83,89,81,91,87,431,431,500
91,94,88,80,92,445,445,500
85,97,87,81,89,439,439,500
82,86,82,84,92,426,426,500
83,87,82,95,84,431,431,500
82,81,86,96,82,427,427,500
86,94,89,99,86,454,454,500
90,82,86,99,83,440,440,500
94,80,91,80,83,428,428,500
82,97,87,90,94,450,450,500
84,80,85,88,97,434,434,500
96,92,83,98,99,468,468,500
88,99,92,82,98,459,459,500
81,82,96,95,99,453,453,500
89,89,88,96,84,446,446,500
84,98,88,96,85,451,451,500
86,90,96,90,92,454,454,500
88,89,87,80,87,431,431,500
88,96,85,83,86,438,438,500
80,81,99,86,90,436,436,500
84,97,84,98,86,449,449,500
89,89,98,89,93,458,458,500
94,93,81,83,90,441,441,500
84,99,89,80,80,432,432,500
83,93,96,88,88,448,448,500
91,96,98,90,95,470,470,500
86,93,85,84,83,431,431,500
94,83,80,93,86,436,436,500
98,87,84,84,97,450,450,500
94,91,96,92,90,463,463,500
92,83,92,88,93,448,448,500
95,98,99,80,84,456,456,500
91,81,90,80,84,426,426,500
99,84,82,83,99,447,447,500
87,81,89,98,92,447,447,500
83,86,83,97,80,429,429,500
95,92,82,82,98,449,449,500
90,98,86,89,91,454,454,500
93,96,91,83,97,460,460,500
82,90,92,83,81,428,428,500
98,88,85,87,97,455,455,500
86,93,88,80,92,439,439,500
82,99,81,80,92,434,434,500
82,87,84,88,91,432,432,500
97,85,83,94,98,457,457,500
80,94,93,87,80,434,434,500
89,99,97,92,92,469,469,500
89,86,97,81,93,446,446,500
89,84,85,92,94,444,444,500
98,97,87,89,89,460,460,500
98,84,89,86,91,448,448,500
87,84,92,93,92,448,448,500
91,95,96,86,96,464,464,500
94,99,80,82,81,436,436,500
90,87,83,85,94,439,439,500
93,93,85,85,83,439,439,500
87,86,96,89,90,448,448,500
94,99,82,86,89,450,450,500
83,95,86,93,80,437,437,500
94,95,97,95,81,462,462,500
97,86,88,93,92,456,456,500
94,98,94,87,92,465,465,500
94,81,82,86,86,429,429,500
86,83,92,86,86,433,433,500
95,98,94,85,93,465,465,500
88,83,91,87,81,430,430,500
93,99,86,93,95,466,466,500
85,85,87,88,95,440,440,500
96,89,92,94,90,461,461,500
99,87,80,94,94,454,454,500
95,80,89,81,84,429,429,500
85,99,82,87,89,442,442,500
80,97,86,85,93,441,441,500
89,80,87,91,95,442,442,500
92,91,83,86,81,433,433,500
89,94,89,82,81,435,435,500
93,88,95,85,88,449,449,500
80,82,86,89,82,419,419,500
82,93,84,97,82,438,438,500
86,84,82,81,95,428,428,500
86,94,88,99,91,458,458,500
80,83,86,86,88,423,423,500
91,83,91,80,94,439,439,500
94,98,81,81,97,451,451,500
90,92,93,90,82,447,447,500
89,89,82,93,99,452,452,500
94,88,99,91,81,453,453,500
92,88,80,81,97,438,438,500
84,85,84,83,97,433,433,500
91,94,92,90,98,465,465,500
97,84,95,94,95,465,465,500
91,82,95,88,99,455,455,500
97,93,90,89,93,462,462,500
98,94,97,84,89,462,462,500
99,94,92,90,80,455,455,500
86,92,89,93,87,447,447,500
89,90,97,97,94,467,467,500
94,85,90,95,84,448,448,500
80,90,92,96,85,443,443,500
91,96,86,81,89,443,443,500
92,81,89,80,92,434,434,500
84,81,96,91,80,432,432,500
81,84,80,90,84,419,419,500
82,88,83,96,81,430,430,500
87,93,81,87,96,444,444,500
89,85,96,98,85,453,453,500
88,86,85,82,96,437,437,500
86,88,86,87,92,439,439,500
88,83,92,80,96,439,439,500
96,99,99,80,81,455,455,500
86,83,93,99,97,458,458,500
97,82,92,95,97,463,463,500
84,82,98,95,81,440,440,500
85,91,82,94,91,443,443,500
94,93,98,94,89,468,468,500
80,90,91,82,96,439,439,500
80,88,87,86,97,438,438,500
91,88,83,98,87,447,447,500
92,99,93,94,89,467,467,500
89,84,95,93,85,446,446,500
99,94,91,94,91,469,469,500
95,82,94,92,80,443,443,500
80,81,97,94,86,438,438,500
92,89,80,88,82,431,431,500
96,97,94,87,86,460,460,500
85,97,86,89,91,448,448,500
80,89,85,98,92,444,444,500
82,82,86,86,84,420,420,500
86,82,88,89,85,430,430,500
80,87,88,84,96,435,435,500
93,89,91,85,90,448,448,500
81,80,90,92,88,431,431,500
93,91,91,91,80,446,446,500
90,93,85,91,80,439,439,500
83,81,88,80,89,421,421,500
90,84,99,96,86,455,455,500
94,88,84,86,98,450,450,500
93,98,86,95,85,457,457,500
97,98,86,81,99,461,461,500
97,97,83,90,92,459,459,500
91,82,80,87,85,425,425,500
87,85,93,82,87,434,434,500
85,84,99,85,90,443,443,500
87,99,83,97,97,463,463,500
83,84,98,81,80,426,426,500
90,89,96,97,95,467,467,500
84,99,99,81,95,458,458,500
95,92,88,94,90,459,459,500
86,89,86,86,97,444,444,500
99,83,92,89,87,450,450,500
95,95,88,94,88,460,460,500
81,84,92,93,81,431,431,500
87,84,81,92,90,434,434,500
90,89,81,82,85,427,427,500
89,90,85,89,99,452,452,500
89,82,96,96,87,450,450,500
99,87,87,92,96,461,461,500
89,85,90,91,94,449,449,500
91,98,88,93,97,467,467,500
92,81,81,90,88,432,432,500
99,90,99,93,89,470,470,500
85,97,93,85,90,450,450,500
81,96,84,91,82,434,434,500
94,99,80,89,90,452,452,500
97,92,88,92,98,467,467,500
92,94,88,99,80,453,453,500
96,97,97,80,81,451,451,500
91,81,80,98,84,434,434,500
99,82,88,80,87,436,436,500
89,87,98,93,82,449,449,500
84,92,92,85,83,436,436,500
83,84,91,85,97,440,440,500
82,88,98,89,93,450,450,500
88,80,86,88,98,440,440,500
91,89,91,84,80,435,435,500
96,91,92,91,83,453,453,500
88,86,98,90,81,443,443,500
84,88,97,95,91,455,455,500
92,86,82,80,89,429,429,500
95,99,94,99,91,478,478,500
96,89,96,87,91,459,459,500
92,99,91,86,84,452,452,500
80,98,88,87,93,446,446,500
82,89,97,84,80,432,432,500
81,86,96,80,93,436,436,500
90,89,92,97,85,453,453,500
86,90,99,85,94,454,454,500
87,89,99,86,83,444,444,500
81,89,80,98,99,447,447,500
86,81,97,88,86,438,438,500
84,98,84,84,81,431,431,500
81,88,93,89,92,443,443,500
87,93,94,85,94,453,453,500
93,91,84,88,98,454,454,500
89,97,93,96,83,458,458,500
92,85,83,85,80,425,425,500
99,86,98,88,90,461,461,500
87,92,88,95,96,458,458,500
92,82,97,95,83,449,449,500
85,87,80,80,86,418,418,500
99,90,87,96,94,466,466,500
80,92,96,84,81,433,433,500
87,96,87,87,93,450,450,500
83,90,88,91,92,444,444,500
95,99,85,82,91,452,452,500
80,94,84,84,83,425,425,500
85,90,94,86,90,445,445,500
94,92,88,89,95,458,458,500
99,88,97,99,87,470,470,500
90,93,82,94,90,449,449,500
94,80,99,90,92,455,455,500
96,91,94,90,82,453,453,500
84,80,89,96,84,433,433,500
81,88,87,96,85,437,437,500
81,98,92,88,98,457,457,500
82,88,99,96,95,460,460,500
85,82,94,92,95,448,448,500
84,95,99,96,83,457,457,500
98,80,88,92,98,456,456,500
81,90,97,84,96,448,448,500
86,99,82,91,84,442,442,500
89,82,86,82,87,426,426,500
88,97,88,90,98,461,461,500
84,87,82,90,98,441,441,500
83,91,83,93,86,436,436,500
90,84,80,80,86,420,420,500
80,90,83,87,82,422,422,500
99,81,90,99,92,461,461,500
90,95,83,84,86,438,438,500
84,99,84,86,84,437,437,500
93,94,90,97,93,467,467,500
89,98,82,90,97,456,456,500
96,93,93,85,87,454,454,500
91,87,81,97,85,441,441,500
82,93,89,88,91,443,443,500
84,86,86,91,93,440,440,500
95,88,87,93,99,462,462,500
82,91,92,96,90,451,451,500
86,83,98,91,81,439,439,500
97,98,97,92,96,480,480,500
93,94,83,94,89,453,453,500
91,80,92,89,99,451,451,500
97,93,89,81,83,443,443,500
83,93,80,86,83,425,425,500
89,94,96,82,88,449,449,500
87,89,82,94,81,433,433,500
84,83,91,80,81,419,419,500
98,83,98,81,83,443,443,500
87,86,87,87,86,433,433,500
85,92,85,96,82,440,440,500
94,95,86,93,90,458,458,500
93,81,82,82,82,420,420,500
89,84,90,94,99,456,456,500
80,90,86,84,85,425,425,500
84,95,98,84,81,442,442,500
84,99,99,81,83,446,446,500
80,97,93,82,83,435,435,500
94,95,90,99,95,473,473,500
93,98,81,94,88,454,454,500
92,95,87,98,82,454,454,500
88,93,84,94,98,457,457,500
88,92,97,94,93,464,464,500
81,95,96,97,94,463,463,500
94,81,80,96,98,449,449,500
97,98,97,91,93,476,476,500
99,80,97,81,94,451,451,500
82,83,87,84,80,416,416,500
98,90,93,90,89,460,460,500
83,99,84,96,90,452,452,500
99,91,88,80,98,456,456,500
80,97,87,90,85,439,439,500
93,86,89,88,94,450,450,500
90,92,92,99,93,466,466,500
85,92,95,92,86,450,450,500
97,90,80,87,91,445,445,500
88,91,83,91,86,439,439,500
82,83,81,85,97,428,428,500
81,82,83,91,91,428,428,500
85,90,89,93,81,438,438,500
91,91,83,92,87,444,444,500
97,92,83,98,84,454,454,500
90,90,82,88,82,432,432,500
80,87,91,97,98,453,453,500
92,82,89,88,83,434,434,500
86,92,81,82,97,438,438,500
90,96,89,92,88,455,455,500
94,84,88,94,89,449,449,500
99,81,89,94,91,454,454,500
93,93,99,84,95,464,464,500
88,97,99,93,88,465,465,500
89,84,90,81,86,430,430,500
86,89,80,80,97,432,432,500
87,80,82,89,96,434,434,500
82,96,94,81,98,451,451,500
92,88,83,83,91,437,437,500
93,89,84,89,98,453,453,500
91,92,86,97,99,465,465,500
92,93,97,92,92,466,466,500
80,83,83,89,90,425,425,500
81,88,86,89,95,439,439,500
84,95,95,84,91,449,449,500
97,84,90,89,92,452,452,500
80,81,89,91,87,428,428,500
86,92,86,90,91,445,445,500
82,95,83,94,84,438,438,500
97,86,93,88,92,456,456,500
89,98,98,85,82,452,452,500
88,83,81,91,89,432,432,500
90,91,83,85,98,447,447,500
85,99,98,92,90,464,464,500
92,83,96,97,92,460,460,500
82,86,96,86,97,447,447,500
95,96,86,83,81,441,441,500
88,97,83,87,99,454,454,500
98,98,91,96,95,478,478,500
89,88,85,80,80,422,422,500
99,88,97,84,96,464,464,500
90,97,82,99,97,465,465,500
93,86,99,88,84,450,450,500
89,86,84,95,82,436,436,500
88,81,88,84,98,439,439,500
83,95,84,96,86,444,444,500
80,98,99,84,97,458,458,500
80,91,98,83,99,451,451,500
83,81,97,99,88,448,448,500
83,83,94,97,95,452,452,500
88,99,97,90,91,465,465,500
87,84,82,83,93,429,429,500
93,97,83,99,89,461,461,500
83,95,99,88,85,450,450,500
87,94,91,97,80,449,449,500
87,96,83,85,88,439,439,500
91,82,82,83,92,430,430,500
81,99,86,86,87,439,439,500
82,83,98,99,83,445,445,500
92,98,86,85,91,452,452,500
93,81,93,81,96,444,444,500
96,85,86,86,81,434,434,500
93,83,85,88,84,433,433,500
84,92,92,93,92,453,453,500
96,84,90,86,80,436,436,500
92,86,98,82,87,445,445,500
95,99,83,82,92,451,451,500
98,92,83,94,83,450,450,500
90,85,86,96,85,442,442,500
85,85,85,86,82,423,423,500
82,88,93,91,82,436,436,500
99,92,93,92,93,469,469,500
85,95,83,96,93,452,452,500
95,97,89,83,96,460,460,500
91,89,93,90,99,462,462,500
89,86,83,86,85,429,429,500
88,91,86,91,92,448,448,500
88,88,89,99,87,451,451,500
91,94,81,98,95,459,459,500
98,95,85,98,95,471,471,500
99,96,96,80,81,452,452,500
89,86,80,84,86,425,425,500
86,92,94,88,86,446,446,500
87,87,88,89,98,449,449,500
97,91,98,85,88,459,459,500
84,93,98,84,93,452,452,500
82,87,94,82,81,426,426,500
93,87,80,85,81,426,426,500
91,94,83,96,82,446,446,500
80,97,84,89,91,441,441,500
87,94,80,98,82,441,441,500
89,91,85,99,86,450,450,500
94,88,95,94,84,455,455,500
90,87,89,87,89,442,442,500
82,94,83,92,95,446,446,500
93,91,99,89,82,454,454,500
93,96,99,80,93,461,461,500
96,82,88,96,93,455,455,500
86,80,98,94,82,440,440,500
87,98,99,81,81,446,446,500
99,98,91,80,84,452,452,500
95,83,86,95,97,456,456,500
80,96,86,88,83,433,433,500
88,88,91,96,94,457,457,500
99,81,88,89,83,440,440,500
93,82,98,83,96,452,452,500
85,80,96,86,93,440,440,500
84,90,86,88,98,446,446,500
92,96,97,94,85,464,464,500
87,88,94,90,87,446,446,500
94,96,96,86,84,456,456,500
93,84,94,95,80,446,446,500
88,87,87,92,90,444,444,500
84,94,92,89,88,447,447,500
87,86,97,89,98,457,457,500
98,81,97,85,97,458,458,500
95,88,93,86,87,449,449,500
80,93,86,91,98,448,448,500
93,88,81,96,81,439,439,500
96,97,88,95,84,460,460,500
86,90,94,92,97,459,459,500
90,89,90,86,80,435,435,500
92,91,98,98,85,464,464,500
89,84,94,81,83,431,431,500
85,95,89,97,92,458,458,500
91,83,96,80,83,433,433,500
88,92,98,90,93,461,461,500
99,93,86,94,92,464,464,500
82,82,82,82,99,427,427,500
95,94,82,87,99,457,457,500
80,85,80,90,99,434,434,500
88,93,84,81,95,441,441,500
88,85,90,96,96,455,455,500
85,96,87,82,97,447,447,500
85,97,90,98,95,465,465,500
83,99,92,88,95,457,457,500
96,89,88,96,92,461,461,500
89,94,81,88,82,434,434,500
87,96,88,80,96,447,447,500
95,81,92,84,81,433,433,500
96,83,89,95,87,450,450,500
95,94,91,95,83,458,458,500
83,82,80,93,89,427,427,500
85,90,85,86,93,439,439,500
83,98,84,98,85,448,448,500
81,87,80,96,96,440,440,500
80,83,85,83,90,421,421,500
95,89,82,86,94,446,446,500
94,90,96,84,91,455,455,500
97,80,88,92,82,439,439,500
91,91,88,81,82,433,433,500
88,96,94,90,92,460,460,500
80,95,97,99,99,470,470,500
82,90,91,88,97,448,448,500
89,98,98,80,97,462,462,500
82,82,87,84,83,418,418,500
98,87,89,81,87,442,442,500
83,96,85,86,93,443,443,500
81,95,95,89,97,457,457,500
86,91,82,91,89,439,439,500
82,85,87,98,82,434,434,500
92,81,82,80,90,425,425,500
80,90,83,94,89,436,436,500
99,91,84,92,97,463,463,500
81,97,91,86,99,454,454,500
85,84,81,99,97,446,446,500
99,87,85,93,80,444,444,500
93,92,90,87,92,454,454,500
86,92,92,80,90,440,440,500
97,86,95,91,98,467,467,500
81,80,87,91,96,435,435,500
80,96,86,92,88,442,442,500
86,83,89,96,87,441,441,500
93,82,93,81,95,444,444,500
81,91,97,88,90,447,447,500
84,99,89,91,98,461,461,500
93,91,94,93,95,466,466,500
93,92,84,92,93,454,454,500
93,92,98,81,80,444,444,500
99,98,92,83,81,453,453,500
85,83,99,95,99,461,461,500
81,94,93,96,95,459,459,500
84,89,83,83,85,424,424,500
97,82,80,87,84,430,430,500
92,82,96,92,98,460,460,500
84,91,83,85,88,431,431,500
94,89,92,97,97,469,469,500
92,99,92,84,98,465,465,500
93,83,83,85,95,439,439,500
97,86,87,93,85,448,448,500
95,84,96,84,84,443,443,500
84,86,93,94,91,448,448,500
85,94,82,86,92,439,439,500
89,94,84,92,85,444,444,500
95,81,93,88,97,454,454,500
93,82,84,90,96,445,445,500
88,91,90,87,80,436,436,500
91,88,84,81,91,435,435,500
81,87,95,88,83,434,434,500
98,84,88,91,99,460,460,500
98,90,85,81,93,447,447,500
95,89,88,97,95,464,464,500
99,84,86,90,84,443,443,500
92,85,82,83,82,424,424,500
93,88,90,98,83,452,452,500
85,89,90,80,84,428,428,500
85,85,81,84,86,421,421,500
85,88,94,93,95,455,455,500
99,87,94,88,94,462,462,500
94,83,93,97,94,461,461,500
81,87,83,95,96,442,442,500
99,94,83,87,86,449,449,500
83,89,88,82,98,440,440,500
86,83,96,93,85,443,443,500
97,89,99,99,83,467,467,500
90,83,89,87,90,439,439,500
86,89,96,83,84,438,438,500
91,93,85,81,99,449,449,500
82,98,94,81,94,449,449,500
85,93,89,86,85,438,438,500
91,91,96,89,91,458,458,500
95,87,87,89,91,449,449,500
95,85,82,95,96,453,453,500
80,80,92,81,95,428,428,500
81,81,99,91,89,441,441,500
89,86,95,93,88,451,451,500
89,86,93,92,98,458,458,500
90,86,80,92,85,433,433,500
93,95,89,97,85,459,459,500
87,82,89,80,93,431,431,500
96,98,92,99,85,470,470,500
95,88,89,83,85,440,440,500
96,98,84,89,96,463,463,500
97,89,91,90,88,455,455,500
85,95,97,90,96,463,463,500
85,88,83,88,87,431,431,500
96,83,96,89,96,460,460,500
94,80,98,91,86,449,449,500
90,97,90,83,92,452,452,500
86,82,89,83,82,422,422,500
96,94,89,84,85,448,448,500
96,92,84,82,93,447,447,500
80,97,92,95,96,460,460,500
82,93,98,95,87,455,455,500
97,89,99,88,82,455,455,500
98,87,97,97,80,459,459,500
83,97,98,83,90,451,451,500
82,97,80,87,81,427,427,500
80,93,80,93,86,432,432,500
91,86,84,90,96,447,447,500
82,96,82,99,81,440,440,500
94,94,93,93,93,467,467,500
87,93,96,84,80,440,440,500
91,85,99,83,93,451,451,500
89,91,99,80,81,440,440,500
92,97,83,99,80,451,451,500
89,99,86,90,90,454,454,500
97,86,88,85,86,442,442,500
83,85,87,94,83,432,432,500
80,92,81,96,91,440,440,500
96,97,80,94,90,457,457,500
87,99,93,93,89,461,461,500
85,95,92,80,85,437,437,500
80,86,89,89,92,436,436,500
89,83,83,97,90,442,442,500
94,96,98,99,92,479,479,500
84,87,96,85,85,437,437,500
86,96,83,92,97,454,454,500
80,82,87,94,97,440,440,500
84,82,96,86,97,445,445,500
88,82,86,90,85,431,431,500
82,96,80,88,88,434,434,500
95,98,86,96,91,466,466,500
89,84,82,88,92,435,435,500
81,82,99,87,84,433,433,500
94,97,89,90,85,455,455,500
99,89,88,91,85,452,452,500
87,81,91,93,99,451,451,500
88,99,86,95,88,456,456,500
87,84,87,99,82,439,439,500
83,91,86,94,87,441,441,500
82,87,90,80,95,434,434,500
92,82,98,80,96,448,448,500
82,85,83,96,99,445,445,500
96,95,87,94,84,456,456,500
90,98,99,80,91,458,458,500
84,93,96,83,86,442,442,500
86,84,82,96,98,446,446,500
91,97,81,91,99,459,459,500
97,81,92,99,89,458,458,500
95,87,91,95,85,453,453,500
92,94,91,80,91,448,448,500
83,88,94,82,99,446,446,500
92,83,94,80,89,438,438,500
97,85,95,98,88,463,463,500
92,87,99,88,91,457,457,500
99,80,85,89,96,449,449,500
81,88,80,98,96,443,443,500
92,96,89,84,96,457,457,500
81,96,92,86,94,449,449,500
90,94,88,87,89,448,448,500
87,87,97,96,81,448,448,500
98,92,81,85,92,448,448,500
94,98,81,89,98,460,460,500
94,91,89,88,93,455,455,500
91,83,84,98,87,443,443,500
88,98,86,92,90,454,454,500
91,86,84,83,94,438,438,500
80,84,92,88,92,436,436,500
89,88,83,92,82,434,434,500
98,83,85,80,83,429,429,500
89,88,85,88,81,431,431,500
97,96,87,94,81,455,455,500
91,83,88,93,89,444,444,500
80,96,90,86,92,444,444,500
94,92,84,95,82,447,447,500
98,91,95,85,96,465,465,500
99,90,98,98,81,466,466,500
88,83,97,88,82,438,438,500
87,98,98,91,95,469,469,500
97,99,93,83,98,470,470,500
97,92,88,95,90,462,462,500
98,82,92,86,82,440,440,500
84,95,96,91,85,451,451,500
98,88,85,85,81,437,437,500
83,85,84,85,91,428,428,500
92,97,80,91,83,443,443,500
92,99,99,93,99,482,482,500
83,93,80,81,82,419,419,500
86,81,90,93,92,442,442,500
81,98,83,98,81,441,441,500
96,95,91,83,92,457,457,500
87,84,87,83,81,422,422,500
97,82,83,93,99,454,454,500
86,83,85,99,99,452,452,500
80,97,98,81,82,438,438,500
94,99,96,85,92,466,466,500
82,97,82,82,83,426,426,500
90,92,87,84,91,444,444,500
85,83,97,99,84,448,448,500
81,98,95,93,92,459,459,500
99,89,87,91,97,463,463,500
80,98,94,81,84,437,437,500
99,91,81,91,83,445,445,500
91,96,93,86,97,463,463,500
81,91,92,85,99,448,448,500
95,97,85,88,88,453,453,500
97,96,84,88,84,449,449,500
91,88,89,88,93,449,449,500
94,81,96,82,81,434,434,500
80,83,82,86,84,415,415,500
81,99,85,86,91,442,442,500
97,87,84,91,87,446,446,500
87,97,93,94,98,469,469,500
98,83,92,87,81,441,441,500
93,85,92,96,82,448,448,500
88,88,90,80,87,433,433,500
83,96,99,98,95,471,471,500
96,92,94,97,83,462,462,500
99,99,83,98,80,459,459,500
83,95,90,85,81,434,434,500
90,94,96,84,94,458,458,500
92,81,91,83,97,444,444,500
82,81,83,90,91,427,427,500
93,89,87,80,82,431,431,500
81,91,99,91,88,450,450,500
89,83,98,87,90,447,447,500
87,89,94,83,95,448,448,500
90,89,92,83,82,436,436,500
99,89,82,81,83,434,434,500
96,95,81,96,95,463,463,500
80,94,98,93,80,445,445,500
80,91,81,80,97,429,429,500
84,91,85,89,86,435,435,500
86,83,82,85,81,417,417,500
96,83,92,86,86,443,443,500
81,90,81,82,94,428,428,500
81,80,90,91,97,439,439,500
85,91,93,93,92,454,454,500
80,94,93,92,85,444,444,500
91,96,93,90,84,454,454,500
82,86,88,94,82,432,432,500
88,92,95,97,83,455,455,500
87,91,94,82,81,435,435,500
83,84,84,86,95,432,432,500
98,92,86,97,82,455,455,500
86,80,98,91,81,436,436,500
84,99,93,86,87,449,449,500
93,94,92,85,81,445,445,500
85,84,96,98,88,451,451,500
90,81,92,93,87,443,443,500
80,87,92,82,93,434,434,500
83,92,98,94,85,452,452,500
90,87,81,88,88,434,434,500
91,98,82,85,92,448,448,500
91,93,97,98,98,477,477,500
96,95,91,96,81,459,459,500
95,89,80,81,91,436,436,500
88,81,86,80,99,434,434,500
91,87,80,88,83,429,429,500
99,99,92,97,86,473,473,500
96,90,86,85,95,452,452,500
81,90,93,89,92,445,445,500
89,96,82,98,88,453,453,500
84,88,83,89,94,438,438,500
99,94,93,89,97,472,472,500
94,88,84,83,98,447,447,500
94,97,91,87,92,461,461,500
85,87,88,80,86,426,426,500
87,80,81,94,91,433,433,500
97,90,92,88,97,464,464,500
97,96,80,97,86,456,456,500
88,87,97,96,97,465,465,500
92,83,85,94,95,449,449,500
91,96,95,94,99,475,475,500
83,97,96,89,85,450,450,500
92,82,94,83,90,441,441,500
84,97,92,82,93,448,448,500
97,85,87,90,83,442,442,500
98,91,87,92,94,462,462,500
80,97,96,81,92,446,446,500
95,95,88,99,83,460,460,500
82,85,87,86,88,428,428,500
92,83,84,80,85,424,424,500
80,94,84,86,81,425,425,500
94,88,90,87,91,450,450,500
91,81,97,93,97,459,459,500
88,93,81,84,97,443,443,500
97,93,80,84,81,435,435,500
81,81,89,91,96,438,438,500
94,88,97,84,88,451,451,500
90,89,85,94,83,441,441,500
84,94,97,94,95,464,464,500
81,94,99,87,97,458,458,500
92,84,83,99,99,457,457,500
84,88,96,94,84,446,446,500
84,91,81,89,91,436,436,500
85,94,90,91,88,448,448,500
80,90,93,94,97,454,454,500
82,92,84,82,97,437,437,500
98,84,88,81,96,447,447,500
97,99,94,91,98,479,479,500
91,96,94,83,97,461,461,500
98,80,97,98,86,459,459,500
80,84,89,80,80,413,413,500
83,83,82,98,82,428,428,500
86,84,95,84,96,445,445,500
93,93,80,97,98,461,461,500
83,82,92,95,80,432,432,500
97,84,84,97,91,453,453,500
87,87,86,97,97,454,454,500
89,95,99,90,93,466,466,500
83,96,80,98,89,446,446,500
85,90,86,95,97,453,453,500
92,93,80,98,96,459,459,500
87,83,86,82,80,418,418,500
89,80,83,89,84,425,425,500
99,95,89,96,95,474,474,500
82,82,91,94,83,432,432,500
88,99,97,95,88,467,467,500
93,86,99,84,90,452,452,500
87,84,80,80,93,424,424,500
97,95,83,91,81,447,447,500
97,94,82,92,92,457,457,500
97,87,93,83,84,444,444,500
92,86,81,86,98,443,443,500
92,82,83,81,87,425,425,500
95,87,98,87,93,460,460,500
85,88,97,86,85,441,441,500
96,84,99,85,86,450,450,500
99,87,94,98,90,468,468,500
96,86,89,89,89,449,449,500
87,96,91,94,85,453,453,500
80,91,94,82,95,442,442,500
83,95,89,81,97,445,445,500
96,99,86,95,85,461,461,500
86,84,92,95,91,448,448,500
81,86,84,97,81,429,429,500
96,99,91,99,88,473,473,500
87,92,96,97,88,460,460,500
82,96,91,93,96,458,458,500
80,82,85,83,99,429,429,500
88,80,86,91,98,443,443,500
81,80,80,80,84,405,405,500
82,84,93,88,99,446,446,500
87,90,91,89,80,437,437,500
85,99,89,95,92,460,460,500
93,90,98,88,88,457,457,500
89,83,98,96,92,458,458,500
89,84,83,86,84,426,426,500
87,95,90,96,98,466,466,500
89,89,85,96,96,455,455,500
86,98,96,87,83,450,450,500
81,82,98,86,92,439,439,500
87,99,82,99,94,461,461,500
96,80,97,97,97,467,467,500
80,94,96,98,96,464,464,500
92,96,86,94,92,460,460,500
92,84,97,91,94,458,458,500
82,82,80,97,98,439,439,500
87,92,95,97,89,460,460,500
84,94,84,90,94,446,446,500
97,84,84,98,87,450,450,500
95,82,92,89,93,451,451,500
96,97,91,97,87,468,468,500
98,80,83,88,83,432,432,500
96,92,98,82,91,459,459,500
92,94,92,90,86,454,454,500
81,98,83,95,96,453,453,500
87,85,87,81,95,435,435,500
86,87,97,92,80,442,442,500
92,85,80,97,92,446,446,500
94,98,93,90,99,474,474,500
86,89,90,89,88,442,442,500
94,93,93,97,82,459,459,500
96,85,88,98,91,458,458,500
88,94,95,98,90,465,465,500
90,99,96,94,98,477,477,500
85,85,97,84,90,441,441,500
80,85,82,87,95,429,429,500
83,95,87,82,83,430,430,500
82,95,94,92,81,444,444,500
83,89,98,94,82,446,446,500
95,99,91,81,86,452,452,500
83,84,82,85,85,419,419,500
81,95,85,83,87,431,431,500
94,81,85,97,86,443,443,500
80,84,82,96,97,439,439,500
94,98,82,84,92,450,450,500
97,97,83,85,84,446,446,500
84,97,96,92,89,458,458,500
80,88,87,88,83,426,426,500
84,92,84,94,93,447,447,500
85,82,90,92,97,446,446,500
93,96,94,98,86,467,467,500
80,93,88,86,84,431,431,500
86,89,87,80,99,441,441,500
90,94,85,93,99,461,461,500
93,81,91,80,81,426,426,500
92,99,83,83,93,450,450,500
80,85,97,97,96,455,455,500
87,89,90,80,93,439,439,500
90,90,93,93,93,459,459,500
94,94,89,95,96,468,468,500
91,95,94,91,94,465,465,500
97,86,83,89,83,438,438,500
86,84,95,90,98,453,453,500
83,80,90,95,95,443,443,500
93,91,96,84,97,461,461,500
84,90,84,85,86,429,429,500
96,95,84,83,93,451,451,500
94,96,85,84,81,440,440,500
97,98,92,93,83,463,463,500
83,92,96,96,82,449,449,500
91,92,87,87,98,455,455,500
82,97,85,92,81,437,437,500
89,86,92,96,96,459,459,500
80,95,89,96,83,443,443,500
83,87,90,94,81,435,435,500
82,93,91,88,98,452,452,500
99,99,99,97,88,482,482,500
94,90,88,94,91,457,457,500
93,88,94,99,96,470,470,500
94,88,80,86,90,438,438,500
90,88,82,86,89,435,435,500
94,98,83,81,89,445,445,500
83,98,83,95,91,450,450,500
83,95,80,80,83,421,421,500
97,87,89,96,81,450,450,500
84,98,92,89,84,447,447,500
97,89,90,86,83,445,445,500
87,84,92,93,80,436,436,500
83,88,97,84,95,447,447,500
82,83,84,94,84,427,427,500
94,83,90,99,91,457,457,500
82,95,80,87,95,439,439,500
85,96,94,87,81,443,443,500
82,85,86,95,87,435,435,500
83,95,98,84,96,456,456,500
97,83,89,98,98,465,465,500
90,80,86,96,91,443,443,500
85,91,99,85,81,441,441,500
92,81,88,94,95,450,450,500
89,87,99,87,83,445,445,500
99,88,94,85,84,450,450,500
81,86,90,89,87,433,433,500
97,81,94,92,82,446,446,500
95,85,84,97,96,457,457,500
85,86,96,99,93,459,459,500
98,85,92,89,85,449,449,500
89,94,93,99,86,461,461,500
83,91,87,87,95,443,443,500
89,94,82,80,86,431,431,500
93,82,90,93,82,440,440,500
86,86,96,89,80,437,437,500
81,82,82,91,80,416,416,500
98,89,82,96,88,453,453,500
96,96,80,89,93,454,454,500
87,95,84,93,87,446,446,500
88,90,99,86,88,451,451,500
97,88,93,89,96,463,463,500
81,94,91,86,87,439,439,500
95,89,99,97,88,468,468,500
92,97,99,96,96,480,480,500
84,99,86,92,82,443,443,500
89,82,88,89,86,434,434,500
89,92,86,94,99,460,460,500
91,98,91,95,92,467,467,500
95,95,98,87,90,465,465,500
84,87,93,99,86,449,449,500
92,80,84,97,91,444,444,500
95,91,84,87,93,450,450,500
94,93,96,80,99,462,462,500
94,85,97,94,86,456,456,500
87,93,98,88,96,462,462,500
98,91,98,89,95,471,471,500
80,82,90,80,88,420,420,500
85,87,96,90,91,449,449,500
97,81,90,96,90,454,454,500
99,93,90,92,81,455,455,500
96,93,97,89,85,460,460,500
86,99,99,90,88,462,462,500
86,92,86,83,86,433,433,500
87,87,91,83,97,445,445,500
87,85,97,97,96,462,462,500
80,84,83,89,92,428,428,500
94,94,97,89,99,473,473,500
80,87,87,94,81,429,429,500
86,87,92,95,94,454,454,500
91,80,98,93,85,447,447,500
98,97,93,80,89,457,457,500
86,91,82,97,95,451,451,500
94,80,92,97,99,462,462,500
88,99,85,97,90,459,459,500
97,85,86,93,88,449,449,500
91,82,81,84,88,426,426,500
93,94,86,95,97,465,465,500
95,81,81,98,88,443,443,500
83,97,91,83,88,442,442,500
95,97,91,93,99,475,475,500
84,89,82,98,80,433,433,500
98,96,86,97,97,474,474,500
81,90,83,95,80,429,429,500
90,94,92,95,96,467,467,500
86,96,97,88,96,463,463,500
80,84,90,82,82,418,418,500
89,80,96,95,91,451,451,500
82,91,92,88,93,446,446,500
88,90,86,98,94,456,456,500
81,99,89,86,97,452,452,500
90,87,81,96,80,434,434,500
86,82,83,87,88,426,426,500
96,95,96,98,98,483,483,500
90,81,90,99,81,441,441,500
86,81,85,80,88,420,420,500
91,83,97,92,88,451,451,500
89,92,84,99,91,455,455,500
95,94,83,83,87,442,442,500
83,82,94,89,81,429,429,500
86,97,81,80,80,424,424,500
96,91,97,98,81,463,463,500
94,84,88,92,90,448,448,500
94,92,88,83,85,442,442,500
85,94,92,97,84,452,452,500
98,91,95,85,80,449,449,500
90,86,85,99,84,444,444,500
88,88,94,93,90,453,453,500
92,98,96,92,92,470,470,500
98,80,92,94,87,451,451,500
87,97,89,96,93,462,462,500
91,89,86,90,96,452,452,500
88,89,85,80,94,436,436,500
81,82,85,97,82,427,427,500
97,91,86,85,82,441,441,500
95,97,94,97,98,481,481,500
83,94,99,86,94,456,456,500
82,86,84,95,98,445,445,500
80,97,96,95,93,461,461,500
86,92,82,83,99,442,442,500
95,91,86,84,88,444,444,500
92,95,96,95,81,459,459,500
90,92,98,85,84,449,449,500
94,98,82,91,84,449,449,500
80,88,88,90,86,432,432,500
94,90,90,93,81,448,448,500
98,88,81,91,99,457,457,500
96,97,93,80,98,464,464,500
97,93,86,96,83,455,455,500
82,84,97,92,94,449,449,500
85,90,91,89,89,444,444,500
93,80,84,91,95,443,443,500
98,80,97,94,95,464,464,500
80,98,84,95,92,449,449,500
98,89,85,93,91,456,456,500
99,83,80,90,93,445,445,500
98,88,95,98,99,478,478,500
88,80,81,93,89,431,431,500
95,86,83,89,93,446,446,500
80,93,83,91,88,435,435,500
85,88,87,98,91,449,449,500
85,94,86,85,80,430,430,500
95,87,98,88,85,453,453,500
97,89,90,87,83,446,446,500
89,84,85,80,83,421,421,500
90,90,86,99,93,458,458,500
80,99,93,92,89,453,453,500
88,82,89,91,95,445,445,500
98,80,93,92,80,443,443,500
90,94,81,93,85,443,443,500
83,92,95,86,87,443,443,500
93,86,91,90,82,442,442,500
89,98,96,99,87,469,469,500
86,91,80,98,86,441,441,500
97,89,84,98,96,464,464,500
87,98,90,93,91,459,459,500
81,89,97,96,97,460,460,500
95,84,85,90,82,436,436,500
85,86,97,88,95,451,451,500
97,86,84,89,89,445,445,500
97,87,87,94,87,452,452,500
97,99,81,86,87,450,450,500
96,97,94,99,91,477,477,500
85,87,87,89,80,428,428,500
96,97,98,80,97,468,468,500
80,85,81,91,91,428,428,500
80,92,89,81,99,441,441,500
95,99,89,83,82,448,448,500
92,83,80,86,86,427,427,500
88,92,95,85,96,456,456,500
93,91,99,86,99,468,468,500
89,90,99,97,85,460,460,500
84,87,95,98,85,449,449,500
95,96,86,89,92,458,458,500
97,98,98,84,82,459,459,500
99,99,97,94,88,477,477,500
89,98,93,97,95,472,472,500
95,96,87,92,93,463,463,500
88,94,87,95,99,463,463,500
94,85,99,81,80,439,439,500
99,84,82,92,86,443,443,500
81,97,91,97,93,459,459,500
81,93,90,86,91,441,441,500
90,84,89,92,85,440,440,500
96,80,91,86,85,438,438,500
86,90,85,85,83,429,429,500
87,95,83,98,82,445,445,500
88,80,98,95,95,456,456,500
82,80,95,89,93,439,439,500
92,89,98,93,88,460,460,500
83,96,80,97,83,439,439,500
80,86,93,89,94,442,442,500
96,84,92,85,96,453,453,500
81,97,94,80,98,450,450,500
83,90,80,88,96,437,437,500
97,98,82,82,92,451,451,500
86,99,96,91,97,469,469,500
94,89,85,92,83,443,443,500
94,84,98,87,94,457,457,500
81,98,93,91,93,456,456,500
87,93,93,84,94,451,451,500
89,93,89,91,85,447,447,500
89,96,88,97,94,464,464,500
92,84,85,82,90,433,433,500
86,87,84,95,81,433,433,500
82,84,91,84,98,439,439,500
85,96,99,90,96,466,466,500
86,90,96,82,87,441,441,500
87,88,81,82,90,428,428,500
94,94,98,84,95,465,465,500
91,96,97,82,94,460,460,500
83,89,91,85,96,444,444,500
94,91,98,88,95,466,466,500
97,85,81,88,90,441,441,500
92,99,88,81,91,451,451,500
86,90,98,84,93,451,451,500
88,89,81,88,92,438,438,500
94,97,88,87,99,465,465,500
91,90,90,94,87,452,452,500
93,97,83,93,82,448,448,500
86,81,81,84,93,425,425,500
94,85,94,96,88,457,457,500
95,88,98,88,95,464,464,500
96,92,81,80,88,437,437,500
87,95,95,80,90,447,447,500
87,94,96,96,94,467,467,500
89,90,80,96,94,449,449,500
99,94,87,89,92,461,461,500
95,91,87,81,81,435,435,500
87,85,93,93,80,438,438,500
85,94,80,97,94,450,450,500
81,85,98,90,89,443,443,500
86,81,98,99,95,459,459,500
98,83,80,92,97,450,450,500
84,94,86,99,90,453,453,500
97,80,91,88,95,451,451,500
97,99,89,84,90,459,459,500
98,98,99,90,98,483,483,500
91,91,80,94,92,448,448,500
81,98,89,84,92,444,444,500
99,81,95,81,92,448,448,500
92,84,95,92,83,446,446,500
97,89,99,83,81,449,449,500
82,99,84,89,90,444,444,500
80,99,94,92,84,449,449,500
99,99,82,86,92,458,458,500
84,87,80,95,91,437,437,500
99,83,84,84,84,434,434,500
86,81,87,98,85,437,437,500
80,92,98,90,93,453,453,500
94,80,85,85,96,440,440,500
85,90,98,97,85,455,455,500
83,89,99,90,97,458,458,500
89,95,84,89,96,453,453,500
89,99,95,92,86,461,461,500
95,96,90,81,82,444,444,500
93,94,84,89,80,440,440,500
98,98,92,89,96,473,473,500
94,96,80,86,92,448,448,500
85,86,98,81,96,446,446,500
87,99,83,96,91,456,456,500
86,82,89,92,94,443,443,500
94,87,83,86,96,446,446,500
82,80,91,84,88,425,425,500
89,88,96,84,93,450,450,500
99,85,85,88,97,454,454,500
90,93,94,92,94,463,463,500
83,92,99,98,95,467,467,500
94,92,84,90,80,440,440,500
80,93,99,80,85,437,437,500
82,83,81,91,89,426,426,500
89,88,81,90,96,444,444,500
93,85,83,98,90,449,449,500
85,86,94,98,82,445,445,500
89,86,97,93,97,462,462,500
89,93,99,82,89,452,452,500
84,83,82,80,87,416,416,500
93,83,81,85,99,441,441,500
92,86,85,85,91,439,439,500
95,87,93,94,88,457,457,500
87,88,97,89,82,443,443,500
88,99,88,88,93,456,456,500
94,81,91,96,85,447,447,500
83,97,95,84,90,449,449,500
89,93,88,99,86,455,455,500
96,84,87,96,80,443,443,500
96,85,98,98,97,474,474,500
92,88,97,98,89,464,464,500
98,80,90,84,96,448,448,500
99,97,80,81,82,439,439,500
82,87,89,86,84,428,428,500
91,82,86,98,96,453,453,500
89,84,89,92,91,445,445,500
82,94,95,98,81,450,450,500
91,86,83,80,83,423,423,500
95,82,85,96,92,450,450,500
92,86,90,96,86,450,450,500
87,87,81,95,83,433,433,500
99,89,91,91,91,461,461,500
82,92,86,99,87,446,446,500
84,88,84,89,95,440,440,500
88,87,82,87,96,440,440,500
92,84,86,99,89,450,450,500
96,96,86,86,80,444,444,500
89,94,82,84,82,431,431,500
81,95,82,94,94,446,446,500
91,97,92,96,89,465,465,500
98,89,96,83,85,451,451,500
84,93,96,84,83,440,440,500
87,94,93,80,85,439,439,500
83,91,95,91,84,444,444,500
81,90,81,89,84,425,425,500
95,97,94,98,80,464,464,500
97,92,90,98,84,461,461,500
97,85,91,82,92,447,447,500
96,82,85,88,97,448,448,500
88,86,99,85,83,441,441,500
91,84,87,86,94,442,442,500
94,93,88,87,83,445,445,500
83,83,97,94,89,446,446,500
88,92,91,92,86,449,449,500
93,84,81,86,86,430,430,500
98,89,82,91,99,459,459,500
88,96,91,86,91,452,452,500
99,83,91,83,95,451,451,500
95,89,97,98,96,475,475,500
83,84,93,87,92,439,439,500
93,87,96,98,84,458,458,500
91,99,85,95,90,460,460,500
97,98,87,83,97,462,462,500
97,95,82,93,95,462,462,500
80,81,96,92,98,447,447,500
82,93,90,92,84,441,441,500
86,82,82,99,96,445,445,500
88,85,99,86,98,456,456,500
97,97,99,95,94,482,482,500
98,88,95,99,94,474,474,500
86,80,88,82,91,427,427,500
97,89,81,92,93,452,452,500
80,89,84,92,97,442,442,500
85,92,98,95,98,468,468,500
80,97,80,96,86,439,439,500
97,92,83,86,80,438,438,500
94,95,82,85,81,437,437,500
88,90,88,90,83,439,439,500
93,93,94,92,97,469,469,500
87,92,89,97,84,449,449,500
92,81,88,91,92,444,444,500
92,97,92,93,88,462,462,500
92,93,96,87,95,463,463,500
95,94,80,94,99,462,462,500
80,84,84,99,85,432,432,500
95,83,91,85,84,438,438,500
99,80,95,91,89,454,454,500
98,82,90,86,84,440,440,500
80,93,99,80,83,435,435,500
83,97,93,97,87,457,457,500
83,85,82,96,98,444,444,500
87,86,86,93,94,446,446,500
98,89,96,96,85,464,464,500
97,96,93,84,88,458,458,500
81,96,93,89,82,441,441,500
89,86,81,84,91,431,431,500
83,93,84,85,85,430,430,500
88,97,85,97,87,454,454,500
80,89,93,80,88,430,430,500
86,98,87,88,97,456,456,500
88,93,82,91,91,445,445,500
85,83,85,90,80,423,423,500
87,88,97,80,81,433,433,500
82,83,85,82,84,416,416,500
91,91,90,91,98,461,461,500
97,96,94,89,89,465,465,500
90,98,88,88,85,449,449,500
84,83,99,80,92,438,438,500
93,92,87,92,87,451,451,500
94,83,97,82,85,441,441,500
80,92,91,88,88,439,439,500
99,91,95,91,92,468,468,500
98,95,86,95,89,463,463,500
99,85,83,98,80,445,445,500
83,83,85,84,97,432,432,500
95,92,89,83,92,451,451,500
88,87,93,82,90,440,440,500
96,92,86,85,80,439,439,500
95,83,86,93,94,451,451,500
96,81,90,99,99,465,465,500
85,83,84,87,93,432,432,500
86,94,86,81,88,435,435,500
87,95,86,86,93,447,447,500
80,85,90,92,96,443,443,500
81,94,97,93,86,451,451,500
99,93,93,90,93,468,468,500
82,86,98,84,92,442,442,500
86,86,93,92,98,455,455,500
91,86,80,86,89,432,432,500
91,82,85,95,85,438,438,500
97,82,84,82,87,432,432,500
97,80,85,88,81,431,431,500
99,97,87,95,93,471,471,500
89,89,96,95,86,455,455,500
96,81,97,91,93,458,458,500
96,81,80,91,96,444,444,500
89,92,92,80,80,433,433,500
95,81,87,87,83,433,433,500
94,88,91,92,89,454,454,500
90,81,86,81,99,437,437,500
96,97,80,88,83,444,444,500
95,90,81,86,87,439,439,500
80,83,92,96,91,442,442,500
92,84,84,91,97,448,448,500
99,96,82,85,82,444,444,500
82,97,82,85,84,430,430,500
94,99,96,90,90,469,469,500
85,84,90,80,86,425,425,500
95,82,97,99,91,464,464,500
90,99,98,87,80,454,454,500
96,89,81,80,95,441,441,500
95,96,96,89,98,474,474,500
82,89,80,92,97,440,440,500
85,88,91,88,89,441,441,500
99,85,83,88,83,438,438,500
80,96,97,80,92,445,445,500
94,87,83,97,91,452,452,500
89,88,92,96,94,459,459,500
83,92,89,92,80,436,436,500
84,90,99,84,88,445,445,500
82,96,80,90,83,431,431,500
86,84,86,83,99,438,438,500
80,88,99,82,84,433,433,500
82,93,80,96,83,434,434,500
94,86,80,98,93,451,451,500
94,93,90,83,87,447,447,500
86,88,80,96,97,447,447,500
81,84,87,82,83,417,417,500
82,97,80,85,80,424,424,500
96,86,92,88,87,449,449,500
98,94,83,94,84,453,453,500
95,86,88,95,96,460,460,500
84,85,91,93,80,433,433,500
82,96,87,85,91,441,441,500
84,82,92,82,99,439,439,500
80,87,97,82,96,442,442,500
82,85,92,90,91,440,440,500
81,86,98,84,94,443,443,500
83,94,96,91,89,453,453,500
91,93,92,93,94,463,463,500
99,93,80,96,95,463,463,500
91,98,88,96,81,454,454,500
93,91,82,90,81,437,437,500
83,89,93,94,97,456,456,500
89,84,80,93,96,442,442,500
94,86,93,96,95,464,464,500
88,90,99,88,98,463,463,500
94,97,86,97,90,464,464,500
98,91,91,96,83,459,459,500
81,87,85,94,87,434,434,500
93,85,99,82,92,451,451,500
91,99,82,97,81,450,450,500
98,85,96,99,87,465,465,500
99,91,91,95,81,457,457,500
96,84,88,87,91,446,446,500
90,81,80,94,97,442,442,500
98,88,93,98,96,473,473,500
84,96,85,84,98,447,447,500
96,80,88,98,85,447,447,500
99,82,87,97,99,464,464,500
87,96,99,90,95,467,467,500
96,95,84,84,97,456,456,500
83,82,96,81,95,437,437,500
82,84,94,99,93,452,452,500
80,99,97,99,94,469,469,500
81,84,90,85,88,428,428,500
88,85,93,93,99,458,458,500
87,98,82,94,85,446,446,500
82,94,95,98,80,449,449,500
93,96,95,81,84,449,449,500
86,89,87,81,89,432,432,500
87,89,84,96,83,439,439,500
88,83,84,88,85,428,428,500
84,89,80,96,81,430,430,500
80,84,85,93,90,432,432,500
95,85,88,98,87,453,453,500
98,83,80,83,80,424,424,500
84,80,92,93,97,446,446,500
90,84,88,97,95,454,454,500
83,93,87,87,89,439,439,500
82,94,80,86,90,432,432,500
86,91,96,85,83,441,441,500
98,81,83,88,86,436,436,500
93,96,89,97,81,456,456,500
80,83,86,86,92,427,427,500
95,92,95,99,85,466,466,500
96,86,84,92,80,438,438,500
80,83,81,98,88,430,430,500
83,98,96,85,97,459,459,500
82,92,94,84,83,435,435,500
92,84,83,86,87,432,432,500
80,96,97,88,93,454,454,500
85,85,84,95,99,448,448,500
99,85,88,97,94,463,463,500
95,91,92,87,89,454,454,500
95,84,90,98,90,457,457,500
86,83,80,82,84,415,415,500
89,82,87,97,95,450,450,500
86,81,98,99,80,444,444,500
99,96,83,86,90,454,454,500
87,93,89,82,82,433,433,500
78,76,70,71,75,370,370,500
78,73,78,77,74,380,380,500
73,78,76,76,77,380,380,500
77,72,71,77,77,374,374,500
76,78,73,70,78,375,375,500
72,78,74,75,73,372,372,500
77,73,72,75,75,372,372,500
75,76,74,77,70,372,372,500
70,75,71,70,71,357,357,500
76,78,76,78,76,384,384,500
76,77,76,75,77,381,381,500
73,77,78,71,74,373,373,500
74,78,71,70,71,364,364,500
78,78,71,71,72,370,370,500
75,75,75,75,71,371,371,500
72,77,75,74,73,371,371,500
76,70,78,75,78,377,377,500
73,70,71,76,73,363,363,500
76,77,76,74,71,374,374,500
72,75,77,70,76,370,370,500
73,71,75,78,70,367,367,500
72,76,74,74,71,367,367,500
72,78,70,74,75,369,369,500
75,73,75,70,76,369,369,500
77,75,78,74,70,374,374,500
73,78,73,73,74,371,371,500
75,73,73,78,70,369,369,500
77,72,78,70,78,375,375,500
74,77,77,78,74,380,380,500
71,73,70,72,72,358,358,500
72,73,74,71,73,363,363,500
72,73,72,72,74,363,363,500
72,75,72,71,78,368,368,500
77,71,76,76,70,370,370,500
72,76,70,78,78,374,374,500
76,76,70,76,77,375,375,500
75,73,72,71,72,363,363,500
74,77,78,76,78,383,383,500
78,74,76,74,77,379,379,500
70,76,76,75,73,370,370,500
72,72,76,71,71,362,362,500
74,77,72,74,78,375,375,500
71,70,76,76,77,370,370,500
77,71,75,77,71,371,371,500
75,76,78,71,74,374,374,500
71,78,74,77,76,376,376,500
78,78,73,74,72,375,375,500
75,77,73,73,77,375,375,500
73,76,77,78,70,374,374,500
78,73,70,71,78,370,370,500
72,74,72,71,77,366,366,500
70,73,70,74,74,361,361,500
72,70,76,72,75,365,365,500
72,70,71,72,78,363,363,500
72,72,72,73,74,363,363,500
70,77,72,77,75,371,371,500
73,74,77,70,70,364,364,500
78,70,75,77,76,376,376,500
75,75,70,71,71,362,362,500
77,75,77,75,71,375,375,500
70,76,74,74,71,365,365,500
70,78,76,75,74,373,373,500
71,71,76,74,77,369,369,500
78,78,76,72,72,376,376,500
77,75,71,73,72,368,368,500
75,74,70,77,76,372,372,500
74,72,72,77,78,373,373,500
71,74,74,78,74,371,371,500
75,76,78,74,78,381,381,500
77,73,75,71,74,370,370,500
71,77,77,77,70,372,372,500
76,70,76,78,73,373,373,500
73,77,73,73,71,367,367,500
77,76,78,72,72,375,375,500
76,76,76,74,77,379,379,500
76,77,76,75,78,382,382,500
73,74,73,72,71,363,363,500
72,71,77,70,78,368,368,500
70,76,78,71,78,373,373,500
71,71,70,76,75,363,363,500
73,73,71,75,76,368,368,500
72,77,75,78,77,379,379,500
76,72,70,73,77,368,368,500
77,74,73,73,71,368,368,500
73,73,70,72,73,361,361,500
74,72,73,70,71,360,360,500
76,70,75,70,76,367,367,500
77,73,75,71,77,373,373,500
77,72,77,70,78,374,374,500
70,70,73,74,72,359,359,500
75,76,75,72,76,374,374,500
78,73,73,76,71,371,371,500
78,76,74,78,74,380,380,500
73,75,72,73,77,370,370,500
73,76,71,71,71,362,362,500
78,77,72,73,71,371,371,500
75,71,75,70,70,361,361,500
73,77,75,77,74,376,376,500
74,74,70,77,71,366,366,500
70,76,71,76,73,366,366,500
78,78,76,72,70,374,374,500
74,73,70,72,75,364,364,500
76,73,76,76,72,373,373,500
77,77,70,76,76,376,376,500
72,72,74,74,72,364,364,500
70,74,72,71,78,365,365,500
70,76,77,70,78,371,371,500
72,71,76,70,71,360,360,500
74,72,76,75,73,370,370,500
71,72,70,73,77,363,363,500
78,76,74,71,70,369,369,500
75,76,77,73,78,379,379,500
78,75,73,76,73,375,375,500
73,73,77,71,73,367,367,500
70,78,71,77,74,370,370,500
73,77,76,78,78,382,382,500
74,75,71,76,74,370,370,500
70,75,78,75,70,368,368,500
73,77,77,78,76,381,381,500
71,75,77,73,72,368,368,500
73,72,70,71,70,356,356,500
73,78,78,71,70,370,370,500
78,74,70,71,75,368,368,500
71,75,76,72,78,372,372,500
73,78,75,72,76,374,374,500
75,73,71,72,72,363,363,500
74,76,76,78,73,377,377,500
75,77,76,75,78,381,381,500
71,70,78,71,76,366,366,500
77,77,72,77,75,378,378,500
77,75,75,72,70,369,369,500
78,76,71,77,74,376,376,500
77,72,77,73,71,370,370,500
70,70,70,71,75,356,356,500
74,77,76,71,72,370,370,500
77,77,74,73,77,378,378,500
72,75,78,77,73,375,375,500
75,72,74,71,70,362,362,500
77,74,73,76,73,373,373,500
70,71,74,77,75,367,367,500
72,72,71,75,73,363,363,500
71,73,73,75,78,370,370,500
77,75,73,76,73,374,374,500
72,70,72,76,70,360,360,500
75,74,75,71,76,371,371,500
72,73,70,74,73,362,362,500
78,74,70,77,75,374,374,500
74,75,74,72,73,368,368,500
72,72,78,70,70,362,362,500
77,71,78,78,74,378,378,500
74,76,78,72,74,374,374,500
76,76,71,75,74,372,372,500
72,76,74,70,71,363,363,500
77,74,70,77,74,372,372,500
71,75,71,78,71,366,366,500
73,77,74,73,75,372,372,500
72,72,75,75,76,370,370,500
75,72,73,78,70,368,368,500
72,74,73,72,74,365,365,500
70,76,70,70,76,362,362,500
73,78,72,77,73,373,373,500
77,74,71,72,74,368,368,500
74,74,73,78,73,372,372,500
75,74,71,74,73,367,367,500
72,76,78,77,75,378,378,500
73,71,75,71,77,367,367,500
71,75,73,77,74,370,370,500
74,73,70,74,72,363,363,500
74,73,71,77,71,366,366,500
76,77,78,76,70,377,377,500
70,77,78,73,73,371,371,500
70,78,70,78,74,370,370,500
73,72,75,74,78,372,372,500
71,76,77,70,76,370,370,500
75,73,76,72,71,367,367,500
76,71,74,71,75,367,367,500
71,70,75,74,78,368,368,500
73,74,72,71,76,366,366,500
76,71,75,76,74,372,372,500
72,78,70,72,73,365,365,500
76,75,73,73,72,369,369,500
77,73,77,70,75,372,372,500
71,73,76,70,76,366,366,500
76,76,72,74,71,369,369,500
74,71,72,77,72,366,366,500
76,74,71,70,73,364,364,500
78,72,78,78,76,382,382,500
72,73,75,76,78,374,374,500
77,76,70,77,74,374,374,500
78,71,74,77,75,375,375,500
78,75,73,74,71,371,371,500
70,78,73,70,74,365,365,500
73,76,76,70,75,370,370,500
71,73,73,74,77,368,368,500
72,73,77,71,75,368,368,500
75,74,73,71,72,365,365,500
74,70,77,72,70,363,363,500
72,71,75,71,70,359,359,500
77,76,75,78,74,380,380,500
78,73,75,74,70,370,370,500
72,76,73,73,76,370,370,500
78,78,73,76,73,378,378,500
70,77,71,71,73,362,362,500
70,71,74,75,73,363,363,500
74,70,76,75,76,371,371,500
77,77,71,73,74,372,372,500
77,71,76,71,76,371,371,500
72,75,78,74,75,374,374,500
71,73,74,77,78,373,373,500
71,74,77,70,72,364,364,500
76,71,70,75,71,363,363,500
71,70,71,72,78,362,362,500
76,74,78,71,71,370,370,500
74,72,71,70,70,357,357,500
76,73,78,75,78,380,380,500
72,73,78,75,74,372,372,500
74,70,74,77,77,372,372,500
75,70,76,72,76,369,369,500
76,76,75,74,72,373,373,500
78,70,70,73,75,366,366,500
70,75,77,70,74,366,366,500
76,77,78,72,77,380,380,500
78,71,74,75,74,372,372,500
70,78,70,70,73,361,361,500
78,73,74,70,71,366,366,500
78,77,77,70,76,378,378,500
72,78,75,78,77,380,380,500
76,70,73,71,72,362,362,500
75,77,72,78,77,379,379,500
70,77,74,75,74,370,370,500
71,74,73,77,71,366,366,500
75,76,76,70,76,373,373,500
70,78,74,72,70,364,364,500
75,73,72,75,71,366,366,500
75,75,75,74,70,369,369,500
70,71,70,77,73,361,361,500
76,78,76,75,77,382,382,500
72,73,71,71,75,362,362,500
71,75,70,77,77,370,370,500
76,78,77,74,73,378,378,500
77,72,71,70,76,366,366,500
78,73,73,73,70,367,367,500
70,70,71,75,70,356,356,500
74,76,74,72,71,367,367,500
71,71,72,77,70,361,361,500
74,74,70,78,75,371,371,500
77,76,77,72,72,374,374,500
70,71,74,78,73,366,366,500
77,73,76,72,71,369,369,500
70,70,70,77,73,360,360,500
73,71,78,74,75,371,371,500
75,71,75,75,72,368,368,500
70,75,74,73,73,365,365,500
73,75,72,73,78,371,371,500
75,76,70,77,73,371,371,500
70,77,73,71,72,363,363,500
77,78,76,73,70,374,374,500
75,70,70,73,73,361,361,500
71,70,71,78,71,361,361,500
73,70,78,75,73,369,369,500
71,71,71,72,74,359,359,500
71,72,70,71,77,361,361,500
75,75,78,75,72,375,375,500
70,73,72,73,77,365,365,500
78,75,75,77,74,379,379,500
72,78,78,70,76,374,374,500
76,74,76,78,77,381,381,500
72,77,72,73,78,372,372,500
77,74,71,76,72,370,370,500
70,73,78,73,70,364,364,500
78,75,78,78,74,383,383,500
73,70,73,75,77,368,368,500
73,71,76,71,71,362,362,500
76,78,75,78,78,385,385,500
70,70,72,72,75,359,359,500
78,78,77,73,74,380,380,500
78,74,72,78,76,378,378,500
77,70,75,74,71,367,367,500
75,73,78,78,76,380,380,500
78,75,72,74,76,375,375,500
74,77,76,74,70,371,371,500
74,78,73,76,73,374,374,500
71,74,72,73,73,363,363,500
74,75,76,73,72,370,370,500
75,70,70,74,75,364,364,500
77,75,78,70,78,378,378,500
78,77,76,76,72,379,379,500
78,70,72,72,76,368,368,500
71,75,78,78,70,372,372,500
75,72,70,74,77,368,368,500
70,72,76,70,76,364,364,500
71,73,71,72,71,358,358,500
78,74,73,72,73,370,370,500
73,71,73,72,74,363,363,500
75,73,70,76,72,366,366,500
72,77,77,73,74,373,373,500
71,74,74,78,71,368,368,500
74,72,74,76,72,368,368,500
78,74,70,78,72,372,372,500
77,75,76,72,77,377,377,500
78,72,71,71,76,368,368,500
70,75,71,72,75,363,363,500
75,77,71,71,70,364,364,500
74,75,75,77,71,372,372,500
75,76,75,70,75,371,371,500
75,71,78,77,78,379,379,500
73,76,73,76,77,375,375,500
78,74,76,77,77,382,382,500
78,74,71,71,77,371,371,500
73,70,70,76,72,361,361,500
73,73,73,71,70,360,360,500
75,72,74,73,70,364,364,500
77,76,72,71,78,374,374,500
70,76,75,76,76,373,373,500
76,77,77,76,77,383,383,500
71,73,72,72,75,363,363,500
72,71,75,72,74,364,364,500
71,78,73,77,74,373,373,500
78,75,71,77,78,379,379,500
70,71,78,78,76,373,373,500
71,77,77,76,73,374,374,500
71,71,78,72,78,370,370,500
70,70,75,77,71,363,363,500
73,70,76,75,72,366,366,500
76,73,75,74,73,371,371,500
78,76,77,71,76,378,378,500
71,72,74,72,70,359,359,500
77,70,74,75,78,374,374,500
70,76,77,75,73,371,371,500
76,77,78,72,76,379,379,500
76,74,76,74,75,375,375,500
78,70,76,72,76,372,372,500
71,71,75,78,74,369,369,500
73,77,73,77,73,373,373,500
76,71,71,73,73,364,364,500
77,78,73,73,76,377,377,500
73,78,75,70,71,367,367,500
78,73,70,78,76,375,375,500
70,70,73,73,73,359,359,500
72,73,78,70,72,365,365,500
74,78,73,77,77,379,379,500
77,70,75,70,74,366,366,500
72,71,77,75,72,367,367,500
78,73,78,73,77,379,379,500
75,71,77,73,78,374,374,500
74,77,75,72,74,372,372,500
71,75,78,76,72,372,372,500
77,70,72,75,72,366,366,500
75,70,77,75,74,371,371,500
78,70,72,74,77,371,371,500
74,74,70,70,73,361,361,500
71,78,75,74,76,374,374,500
78,72,76,72,78,376,376,500
78,74,70,77,73,372,372,500
73,77,75,72,76,373,373,500
75,75,73,70,71,364,364,500
72,76,70,76,71,365,365,500
71,78,73,71,78,371,371,500
74,76,78,77,76,381,381,500
71,71,78,75,75,370,370,500
72,77,74,78,76,377,377,500
75,76,75,74,74,374,374,500
78,74,73,78,77,380,380,500
77,76,72,73,78,376,376,500
77,70,76,73,72,368,368,500
74,75,71,72,73,365,365,500
73,70,74,73,73,363,363,500
74,70,76,76,75,371,371,500
71,74,71,75,77,368,368,500
72,78,78,71,70,369,369,500
70,78,71,77,70,366,366,500
75,70,77,78,73,373,373,500
70,74,70,73,74,361,361,500
71,72,78,72,71,364,364,500
73,74,71,75,71,364,364,500
71,74,78,76,70,369,369,500
73,77,78,74,73,375,375,500
73,72,76,78,70,369,369,500
77,72,70,74,76,369,369,500
71,72,78,78,74,373,373,500
77,75,73,70,76,371,371,500
76,77,78,77,73,381,381,500
70,74,72,77,70,363,363,500
74,72,76,71,70,363,363,500
73,77,73,73,71,367,367,500
76,72,78,77,71,374,374,500
78,73,70,74,77,372,372,500
77,77,72,70,74,370,370,500
75,76,73,75,75,374,374,500
78,74,70,72,78,372,372,500
77,71,76,76,72,372,372,500
76,75,77,71,75,374,374,500
77,77,70,78,70,372,372,500
76,77,72,74,71,370,370,500
77,75,77,75,74,378,378,500
75,73,78,77,70,373,373,500
74,72,75,77,76,374,374,500
70,72,78,77,78,375,375,500
78,70,74,72,71,365,365,500
73,75,73,78,76,375,375,500
73,77,71,74,72,367,367,500
77,75,70,77,75,374,374,500
70,75,70,77,73,365,365,500
77,76,72,77,72,374,374,500
75,78,76,74,71,374,374,500
71,75,73,77,71,367,367,500
72,74,73,74,77,370,370,500
77,72,70,74,70,363,363,500
77,73,73,75,75,373,373,500
76,75,70,74,78,373,373,500
78,78,72,71,76,375,375,500
74,75,70,70,70,359,359,500
78,78,77,70,73,376,376,500
76,71,76,75,76,374,374,500
78,78,72,76,70,374,374,500
77,78,70,70,70,365,365,500
70,71,75,73,70,359,359,500
70,76,74,77,76,373,373,500
75,73,74,71,73,366,366,500
76,74,78,78,75,381,381,500
76,78,78,76,73,381,381,500
70,72,72,71,77,362,362,500
73,78,71,76,74,372,372,500
70,77,73,72,71,363,363,500
76,74,76,78,76,380,380,500
70,72,73,72,75,362,362,500
74,78,70,74,76,372,372,500
78,76,77,74,76,381,381,500
78,70,71,76,76,371,371,500
78,78,70,77,73,376,376,500
71,75,70,73,75,364,364,500
70,75,76,71,74,366,366,500
78,73,70,75,76,372,372,500
70,77,77,74,73,371,371,500
70,71,73,76,74,364,364,500
71,75,73,71,73,363,363,500
78,71,75,72,78,374,374,500
77,70,76,72,74,369,369,500
78,73,72,71,73,367,367,500
76,74,78,71,77,376,376,500
74,77,77,75,74,377,377,500
71,70,74,78,75,368,368,500
78,72,74,77,71,372,372,500
75,76,71,71,74,367,367,500
74,70,73,75,75,367,367,500
73,75,73,73,72,366,366,500
74,76,73,75,74,372,372,500
71,70,75,75,74,365,365,500
73,78,74,71,72,368,368,500
75,75,71,72,73,366,366,500
78,73,77,74,75,377,377,500
70,75,77,77,71,370,370,500
72,77,70,78,70,367,367,500
73,70,70,72,75,360,360,500
71,78,74,71,75,369,369,500
71,77,71,70,78,367,367,500
70,76,76,78,78,378,378,500
70,74,76,70,76,366,366,500
78,76,70,76,78,378,378,500
70,77,77,74,74,372,372,500
70,76,77,76,75,374,374,500
71,71,73,76,77,368,368,500
77,76,72,77,76,378,378,500
78,77,78,78,73,384,384,500
77,76,74,73,72,372,372,500
75,74,71,76,71,367,367,500
76,73,78,73,73,373,373,500
75,71,72,72,70,360,360,500
77,76,73,78,78,382,382,500
74,71,76,71,72,364,364,500
73,75,75,78,70,371,371,500
73,73,73,73,76,368,368,500
74,71,74,72,76,367,367,500
74,76,70,77,76,373,373,500
77,75,74,76,71,373,373,500
75,77,74,73,70,369,369,500
70,78,74,74,72,368,368,500
70,71,76,72,73,362,362,500
74,74,77,78,74,377,377,500
75,75,72,70,76,368,368,500
71,75,71,77,73,367,367,500
72,72,78,72,75,369,369,500
74,75,70,70,77,366,366,500
76,72,75,74,78,375,375,500
76,71,76,76,71,370,370,500
72,70,73,74,77,366,366,500
77,70,76,77,76,376,376,500
74,78,76,70,75,373,373,500
71,72,70,72,77,362,362,500
78,77,70,72,72,369,369,500
77,74,77,73,70,371,371,500
74,71,77,70,73,365,365,500
70,75,73,72,73,363,363,500
74,76,78,78,73,379,379,500
72,75,77,77,70,371,371,500
72,77,75,74,70,368,368,500
71,71,74,78,70,364,364,500
76,74,71,73,75,369,369,500
72,71,72,76,71,362,362,500
72,74,78,72,71,367,367,500
74,72,70,74,73,363,363,500
78,71,71,78,76,374,374,500
71,71,75,78,73,368,368,500
77,77,70,74,77,375,375,500
73,76,76,72,77,374,374,500
77,78,73,74,76,378,378,500
77,71,77,74,72,371,371,500
70,77,77,71,78,373,373,500
76,73,73,75,70,367,367,500
75,74,72,75,72,368,368,500
78,71,70,72,78,369,369,500
70,70,72,78,75,365,365,500
70,74,78,77,78,377,377,500
76,78,76,71,74,375,375,500
71,78,76,77,76,378,378,500
77,74,75,78,75,379,379,500
75,70,70,71,73,359,359,500
70,71,77,77,71,366,366,500
74,70,73,76,75,368,368,500
70,74,71,72,75,362,362,500
71,78,75,73,73,370,370,500
73,74,70,76,72,365,365,500
71,77,73,75,72,368,368,500
75,74,75,76,78,378,378,500
70,77,71,71,73,362,362,500
70,75,75,70,76,366,366,500
70,74,72,78,76,370,370,500
78,76,73,78,71,376,376,500
76,70,71,73,70,360,360,500
72,78,75,78,75,378,378,500
70,78,73,73,75,369,369,500
72,78,73,75,72,370,370,500
74,74,71,72,75,366,366,500
72,77,75,75,73,372,372,500
78,73,71,74,73,369,369,500
78,78,73,76,77,382,382,500
70,73,72,71,74,360,360,500
78,78,78,72,78,384,384,500
77,78,74,70,76,375,375,500
72,75,73,75,74,369,369,500
75,73,75,77,71,371,371,500
73,71,75,76,75,370,370,500
77,74,73,78,70,372,372,500
78,73,71,73,73,368,368,500
75,71,77,75,70,368,368,500
71,78,77,77,71,374,374,500
78,73,78,76,70,375,375,500
73,72,73,77,75,370,370,500
72,75,76,71,73,367,367,500
75,78,75,73,71,372,372,500
74,70,73,74,75,366,366,500
70,76,70,78,78,372,372,500
75,73,70,70,70,358,358,500
77,78,74,70,75,374,374,500
76,73,76,71,74,370,370,500
74,71,76,75,77,373,373,500
73,77,70,70,78,368,368,500
77,78,72,77,71,375,375,500
78,73,76,72,70,369,369,500
75,76,76,77,72,376,376,500
76,70,75,71,77,369,369,500
73,72,75,76,76,372,372,500
76,78,72,73,75,374,374,500
72,76,71,75,71,365,365,500
74,76,70,70,77,367,367,500
77,77,74,76,75,379,379,500
75,72,73,72,73,365,365,500
76,72,78,72,73,371,371,500
77,77,77,71,72,374,374,500
71,75,71,74,71,362,362,500
77,78,70,73,74,372,372,500
77,77,78,77,78,387,387,500
71,76,78,77,75,377,377,500
72,76,73,74,73,368,368,500
73,77,76,77,73,376,376,500
78,75,72,75,75,375,375,500
73,73,72,77,71,366,366,500
70,71,72,77,73,363,363,500
77,77,78,77,74,383,383,500
70,71,72,71,76,360,360,500
71,78,75,70,70,364,364,500
75,75,74,70,78,372,372,500
75,75,71,75,76,372,372,500
77,78,70,78,71,374,374,500
70,72,72,72,73,359,359,500
76,71,74,75,76,372,372,500
70,73,75,76,71,365,365,500
76,73,78,73,71,371,371,500
74,77,74,76,71,372,372,500
77,70,71,74,70,362,362,500
70,77,76,78,78,379,379,500
71,77,73,73,76,370,370,500
75,76,73,77,74,375,375,500
74,71,78,72,74,369,369,500
75,78,72,76,77,378,378,500
77,77,73,78,76,381,381,500
77,72,75,76,75,375,375,500
76,77,78,76,70,377,377,500
78,71,77,77,71,374,374,500
78,77,75,77,71,378,378,500
76,78,78,75,70,377,377,500
70,74,71,71,76,362,362,500
75,70,73,71,75,364,364,500
74,73,71,72,78,368,368,500
72,75,73,74,73,367,367,500
74,76,73,70,74,367,367,500
70,70,72,73,76,361,361,500
77,76,76,70,72,371,371,500
75,75,78,71,73,372,372,500
72,75,78,73,78,376,376,500
77,76,70,71,76,370,370,500
76,75,72,71,74,368,368,500
70,72,76,72,73,363,363,500
78,75,78,70,73,374,374,500
70,77,76,74,74,371,371,500
70,74,71,72,78,365,365,500
75,77,78,70,78,378,378,500
76,78,77,73,70,374,374,500
78,76,73,77,75,379,379,500
72,71,73,78,72,366,366,500
77,76,71,76,73,373,373,500
71,71,78,78,77,375,375,500
73,76,70,77,72,368,368,500
72,72,70,76,75,365,365,500
77,71,70,72,73,363,363,500
76,75,72,72,76,371,371,500
77,78,78,76,73,382,382,500
71,71,72,70,75,359,359,500
71,71,77,75,73,367,367,500
76,75,72,77,73,373,373,500
74,75,78,72,74,373,373,500
72,72,75,72,76,367,367,500
76,75,78,70,70,369,369,500
74,76,71,73,71,365,365,500
75,78,70,75,70,368,368,500
78,74,71,73,70,366,366,500
70,74,75,72,73,364,364,500
73,78,76,76,75,378,378,500
72,71,70,72,72,357,357,500
77,72,74,73,77,373,373,500
77,70,75,77,77,376,376,500
77,72,70,76,71,366,366,500
70,78,76,77,77,378,378,500
74,78,76,70,75,373,373,500
70,72,70,77,73,362,362,500
75,72,71,77,77,372,372,500
72,78,72,74,77,373,373,500
78,72,72,73,78,373,373,500
78,73,72,71,72,366,366,500
74,75,73,75,73,370,370,500
77,78,74,72,73,374,374,500
70,74,77,78,78,377,377,500
70,75,75,77,73,370,370,500
74,70,71,74,72,361,361,500
71,77,76,72,78,374,374,500
71,72,72,78,72,365,365,500
75,73,77,74,72,371,371,500
78,77,77,76,78,386,386,500
70,77,76,72,71,366,366,500
74,78,73,74,76,375,375,500
77,73,75,74,76,375,375,500
75,73,72,70,76,366,366,500
72,73,75,78,73,371,371,500
71,78,70,77,70,366,366,500
78,77,72,75,73,375,375,500
70,76,77,73,72,368,368,500
72,70,74,71,72,359,359,500
71,71,78,76,75,371,371,500
72,74,75,75,71,367,367,500
74,76,70,71,74,365,365,500
74,75,75,77,76,377,377,500
76,78,77,76,73,380,380,500
70,78,76,73,70,367,367,500
72,78,76,73,76,375,375,500
71,77,74,70,76,368,368,500
75,78,73,76,70,372,372,500
71,75,73,70,74,363,363,500
73,74,75,71,76,369,369,500
76,78,74,72,77,377,377,500
72,73,76,78,77,376,376,500
78,78,72,71,74,373,373,500
77,73,75,74,73,372,372,500
77,77,78,76,70,378,378,500
73,71,77,75,72,368,368,500
78,70,72,73,75,368,368,500
73,77,77,74,77,378,378,500
75,76,70,70,77,368,368,500
72,73,76,75,75,371,371,500
76,76,71,75,72,370,370,500
70,70,76,75,72,363,363,500
70,75,70,70,76,361,361,500
76,78,72,75,70,371,371,500
70,78,73,77,71,369,369,500
70,70,70,70,72,352,352,500
75,70,70,77,72,364,364,500
70,75,75,73,76,369,369,500
74,75,73,73,71,366,366,500
71,71,75,72,78,367,367,500
78,70,74,78,70,370,370,500
70,77,77,73,71,368,368,500
70,74,74,71,74,363,363,500
77,78,75,70,70,370,370,500
76,75,72,75,73,371,371,500
75,73,70,78,75,371,371,500
74,75,74,70,74,367,367,500
75,72,75,77,70,369,369,500
76,77,74,74,78,379,379,500
70,73,70,75,76,364,364,500
73,78,74,70,73,368,368,500
78,72,78,76,71,375,375,500
70,71,72,76,74,363,363,500
75,74,76,75,71,371,371,500
76,76,71,77,77,377,377,500
75,78,74,72,70,369,369,500
74,78,77,72,73,374,374,500
73,76,72,75,74,370,370,500
74,78,78,76,78,384,384,500
77,73,75,71,71,367,367,500
78,77,78,72,77,382,382,500
76,70,77,74,74,371,371,500
72,77,75,72,76,372,372,500
78,76,72,71,71,368,368,500
74,77,73,76,70,370,370,500
73,71,70,70,78,362,362,500
70,72,77,71,75,365,365,500
77,70,74,73,74,368,368,500
76,71,71,72,73,363,363,500
78,70,78,71,70,367,367,500
70,75,76,70,72,363,363,500
76,74,73,76,76,375,375,500
76,77,74,72,77,376,376,500
75,78,76,71,71,371,371,500
75,75,77,72,73,372,372,500
72,74,71,72,76,365,365,500
78,77,78,70,75,378,378,500
71,78,77,75,74,375,375,500
70,76,70,76,75,367,367,500
78,76,77,72,72,375,375,500
77,77,78,75,72,379,379,500
76,74,74,72,75,371,371,500
77,78,77,78,76,386,386,500
73,76,76,77,74,376,376,500
77,74,75,77,73,376,376,500
71,77,72,78,78,376,376,500
70,71,76,78,70,365,365,500
70,71,72,74,76,363,363,500
71,74,71,75,72,363,363,500
72,70,75,78,75,370,370,500
78,77,70,72,76,373,373,500
70,78,73,78,72,371,371,500
74,71,74,72,72,363,363,500
72,71,70,75,77,365,365,500
76,70,76,75,77,374,374,500
77,73,71,77,78,376,376,500
72,73,76,73,78,372,372,500
73,70,71,73,75,362,362,500
72,78,73,78,70,371,371,500
76,78,74,72,73,373,373,500
74,70,78,77,74,373,373,500
76,78,76,72,73,375,375,500
74,71,71,71,78,365,365,500
73,74,71,74,71,363,363,500
74,76,71,78,78,377,377,500
74,71,73,77,78,373,373,500
74,73,73,78,74,372,372,500
77,72,70,78,72,369,369,500
71,76,77,78,70,372,372,500
75,72,74,77,72,370,370,500
77,78,75,71,77,378,378,500
78,75,74,72,70,369,369,500
72,76,70,71,71,360,360,500
78,75,77,75,74,379,379,500
70,72,71,78,75,366,366,500
71,70,73,74,76,364,364,500
71,72,76,72,77,368,368,500
70,76,76,71,70,363,363,500
73,73,75,73,77,371,371,500
78,72,75,74,72,371,371,500
77,76,72,76,77,378,378,500
74,77,72,70,71,364,364,500
71,76,73,70,71,361,361,500
74,77,71,71,73,366,366,500
71,76,74,72,77,370,370,500
77,70,77,78,74,376,376,500
70,75,72,71,73,361,361,500
70,75,73,78,70,366,366,500
72,77,73,72,77,371,371,500
75,77,71,71,73,367,367,500
76,72,74,70,78,370,370,500
78,77,70,71,75,371,371,500
73,72,78,75,78,376,376,500
73,70,78,76,76,373,373,500
72,71,77,76,71,367,367,500
78,77,73,76,75,379,379,500
75,71,74,75,77,372,372,500
78,76,76,73,77,380,380,500
77,74,77,73,73,374,374,500
76,74,70,74,76,370,370,500
73,78,71,73,76,371,371,500
71,78,78,74,76,377,377,500
73,73,77,73,75,371,371,500
78,70,75,74,73,370,370,500
72,78,76,70,73,369,369,500
78,73,70,78,72,371,371,500
71,74,76,71,78,370,370,500
71,77,72,78,76,374,374,500
73,78,77,74,74,376,376,500
72,70,70,70,74,356,356,500
72,70,78,70,72,362,362,500
74,74,78,71,77,374,374,500
75,78,70,78,70,371,371,500
78,77,73,73,78,379,379,500
77,74,77,74,71,373,373,500
74,74,73,70,77,368,368,500
73,73,73,71,75,365,365,500
71,76,75,71,73,366,366,500
74,71,70,72,74,361,361,500
76,72,76,77,73,374,374,500
70,70,74,75,73,362,362,500
77,70,75,75,75,372,372,500
78,73,78,73,77,379,379,500
75,72,76,70,71,364,364,500
72,74,78,78,75,377,377,500
74,74,72,78,70,368,368,500
77,73,75,76,70,371,371,500
73,72,74,75,76,370,370,500
70,78,78,73,70,369,369,500
75,78,76,70,75,374,374,500
72,78,71,77,70,368,368,500
74,75,78,73,75,375,375,500
75,76,75,72,77,375,375,500
70,70,71,70,73,354,354,500
75,76,74,77,70,372,372,500
71,78,76,76,76,377,377,500
74,77,74,72,73,370,370,500
75,73,72,70,73,363,363,500
72,72,77,76,75,372,372,500
72,73,72,75,76,368,368,500
76,77,77,78,74,382,382,500
72,71,77,72,70,362,362,500
78,76,78,77,78,387,387,500
72,75,70,75,70,362,362,500
78,76,71,76,76,377,377,500
78,76,78,78,74,384,384,500
76,73,75,77,73,374,374,500
72,70,74,77,76,369,369,500
78,71,75,75,77,376,376,500
73,71,73,78,73,368,368,500
71,74,74,76,73,368,368,500
75,77,72,73,72,369,369,500
76,76,72,76,76,376,376,500
71,77,78,74,73,373,373,500
74,77,75,74,78,378,378,500
72,76,76,72,70,366,366,500
71,78,78,78,77,382,382,500
77,77,72,70,73,369,369,500
77,70,74,76,71,368,368,500
73,73,78,76,77,377,377,500
75,72,75,74,75,371,371,500
75,74,72,71,71,363,363,500
73,70,76,75,76,370,370,500
78,75,74,70,73,370,370,500
70,77,72,72,74,365,365,500
74,76,75,75,72,372,372,500
74,72,74,71,70,361,361,500
75,76,72,74,70,367,367,500
72,74,76,75,74,371,371,500
70,76,70,71,76,363,363,500
78,71,70,70,72,361,361,500
77,71,70,74,70,362,362,500
71,70,74,72,73,360,360,500
71,71,73,76,78,369,369,500
77,73,76,72,70,368,368,500
76,77,75,75,75,378,378,500
75,72,72,72,71,362,362,500
76,76,73,73,74,372,372,500
73,75,74,71,73,366,366,500
72,72,72,74,77,367,367,500
76,76,71,73,74,370,370,500
74,76,78,78,74,380,380,500
76,70,73,77,78,374,374,500
75,73,73,75,77,373,373,500
75,70,75,73,75,368,368,500
71,71,78,74,72,366,366,500
74,78,70,73,75,370,370,500
71,74,77,78,75,375,375,500
72,72,70,71,70,355,355,500
70,72,74,70,78,364,364,500
74,77,76,72,72,371,371,500
72,71,71,71,76,361,361,500
76,70,73,73,75,367,367,500
78,78,76,77,76,385,385,500
71,70,72,77,72,362,362,500
77,71,70,75,77,370,370,500
77,78,75,70,72,372,372,500
71,71,73,77,71,363,363,500
71,78,71,75,71,366,366,500
70,74,77,77,71,369,369,500
72,77,78,73,72,372,372,500
73,74,73,74,75,369,369,500
75,71,73,71,73,363,363,500
78,73,74,70,72,367,367,500
71,77,72,70,77,367,367,500
76,75,73,76,72,372,372,500
72,71,76,77,77,373,373,500
72,71,71,74,72,360,360,500
74,77,77,72,71,371,371,500
75,72,77,70,74,368,368,500
74,78,78,74,74,378,378,500
70,70,74,78,75,367,367,500
72,75,76,72,70,365,365,500
75,72,70,75,73,365,365,500
75,76,75,72,74,372,372,500
76,73,77,75,72,373,373,500
74,74,72,71,73,364,364,500
75,72,72,70,75,364,364,500
73,75,74,76,74,372,372,500
71,73,77,76,78,375,375,500
71,75,78,78,70,372,372,500
74,72,71,72,71,360,360,500
74,76,72,70,72,364,364,500
75,74,75,73,76,373,373,500
71,75,71,77,76,370,370,500
78,72,76,72,78,376,376,500
75,77,78,77,72,379,379,500
72,72,76,78,74,372,372,500
78,77,74,71,72,372,372,500
78,78,72,74,78,380,380,500
78,70,78,77,78,381,381,500
78,70,76,76,71,371,371,500
77,78,72,71,75,373,373,500
76,72,71,73,78,370,370,500
70,78,72,71,71,362,362,500
70,75,76,75,77,373,373,500
70,72,72,78,78,370,370,500
77,71,75,75,72,370,370,500
71,70,78,76,71,366,366,500
77,75,71,74,78,375,375,500
77,72,73,73,74,369,369,500
72,75,72,76,73,368,368,500
73,75,75,73,74,370,370,500
73,75,76,77,74,375,375,500
77,71,73,74,73,368,368,500
73,70,78,73,71,365,365,500
75,75,78,77,77,382,382,500
76,70,73,76,77,372,372,500
71,72,72,73,78,366,366,500
77,74,72,77,76,376,376,500
72,76,78,71,75,372,372,500
77,75,76,73,75,376,376,500
76,75,74,73,71,369,369,500
75,75,76,73,77,376,376,500
74,77,74,76,77,378,378,500
71,70,74,70,75,360,360,500
70,71,78,78,71,368,368,500
77,70,76,70,75,368,368,500
77,74,71,73,75,370,370,500
74,71,74,73,77,369,369,500
72,75,78,77,76,378,378,500
73,74,76,75,75,373,373,500
75,76,78,73,77,379,379,500
70,77,74,70,72,363,363,500
75,70,78,73,77,373,373,500
78,71,73,73,75,370,370,500
71,70,72,73,77,363,363,500
76,75,70,77,70,368,368,500
73,71,77,76,76,373,373,500
75,71,77,70,72,365,365,500
74,75,71,70,70,360,360,500
71,70,75,72,71,359,359,500
70,74,76,72,77,369,369,500
75,72,76,77,75,375,375,500
78,74,77,70,76,375,375,500
75,76,74,74,74,373,373,500
77,74,77,72,75,375,375,500
75,72,70,73,75,365,365,500
74,74,76,77,75,376,376,500
78,72,73,73,71,367,367,500
78,78,72,71,78,377,377,500
72,74,74,72,77,369,369,500
70,71,75,77,70,363,363,500
75,72,76,70,70,363,363,500
78,73,71,70,73,365,365,500
78,78,76,76,70,378,378,500
74,75,77,78,77,381,381,500
70,72,71,71,74,358,358,500
76,78,71,76,76,377,377,500
74,78,77,76,72,377,377,500
74,73,77,72,71,367,367,500
77,76,76,74,78,381,381,500
71,76,76,77,71,371,371,500
74,71,74,73,71,363,363,500
72,71,73,73,73,362,362,500
71,75,73,70,71,360,360,500
78,71,70,72,75,366,366,500
70,71,73,70,73,357,357,500
77,73,75,70,71,366,366,500
76,77,71,72,77,373,373,500
75,72,75,76,73,371,371,500
74,76,72,74,74,370,370,500
77,70,78,77,72,374,374,500
77,76,73,70,78,374,374,500
70,74,76,73,71,364,364,500
78,75,76,72,74,375,375,500
74,70,70,77,70,361,361,500
72,75,70,72,77,366,366,500
71,70,75,78,76,370,370,500
70,77,76,77,77,377,377,500
71,76,75,71,75,368,368,500
74,77,73,77,74,375,375,500
74,76,72,71,73,366,366,500
73,70,75,73,77,368,368,500
73,74,74,78,73,372,372,500
77,78,76,75,70,376,376,500
73,74,76,75,76,374,374,500
72,71,78,77,70,368,368,500
76,78,75,75,70,374,374,500
71,76,77,73,75,372,372,500
78,73,71,74,72,368,368,500
73,74,71,72,71,361,361,500
72,77,78,71,70,368,368,500
76,76,77,77,75,381,381,500
73,77,75,74,72,371,371,500
71,70,73,72,73,359,359,500
77,73,70,76,70,366,366,500
74,78,78,71,72,373,373,500
76,76,71,74,78,375,375,500
70,76,75,75,76,372,372,500
75,78,75,76,74,378,378,500
70,78,76,74,75,373,373,500
78,72,77,76,75,378,378,500
73,71,75,72,74,365,365,500
78,73,70,73,74,368,368,500
78,78,72,71,77,376,376,500
70,78,76,70,74,368,368,500
75,74,72,73,74,368,368,500
70,76,77,76,78,377,377,500
75,76,76,72,71,370,370,500
78,70,70,72,74,364,364,500
72,70,74,71,75,362,362,500
78,77,77,74,76,382,382,500
76,74,75,75,76,376,376,500
75,75,77,72,70,369,369,500
78,73,75,71,70,367,367,500
77,76,75,73,78,379,379,500
72,72,70,71,73,358,358,500
71,74,74,71,73,363,363,500
73,72,73,72,78,368,368,500
70,74,76,75,72,367,367,500
72,70,70,73,77,362,362,500
73,72,75,76,77,373,373,500
77,73,72,72,72,366,366,500
73,73,75,76,71,368,368,500
72,72,76,78,70,368,368,500
73,76,77,75,74,375,375,500
76,75,71,76,73,371,371,500
70,74,75,71,75,365,365,500
72,76,73,77,75,373,373,500
78,74,71,72,71,366,366,500
70,76,77,72,77,372,372,500
76,74,72,76,78,376,376,500
76,73,78,74,76,377,377,500
78,72,74,73,78,375,375,500
75,75,71,75,77,373,373,500
75,73,76,71,74,369,369,500
77,71,71,70,74,363,363,500
71,76,76,75,76,374,374,500
72,73,71,74,76,366,366,500
77,75,73,73,76,374,374,500
72,78,75,74,77,376,376,500
71,77,73,72,72,365,365,500
77,71,72,76,78,374,374,500
71,70,74,77,71,363,363,500
74,75,71,74,74,368,368,500
78,70,73,76,70,367,367,500
77,75,70,71,78,371,371,500
77,76,74,76,76,379,379,500
72,70,78,73,71,364,364,500
75,74,71,78,73,371,371,500
71,73,78,72,72,366,366,500
71,76,74,75,75,371,371,500
77,78,72,77,77,381,381,500
76,71,73,72,70,362,362,500
73,70,72,70,71,356,356,500
71,70,75,77,71,364,364,500
77,75,76,70,74,372,372,500
70,72,78,71,71,362,362,500
72,75,70,70,73,360,360,500
70,72,78,70,72,362,362,500
72,70,71,77,74,364,364,500
70,75,77,74,74,370,370,500
72,73,73,75,73,366,366,500
75,78,73,74,77,377,377,500
72,78,71,70,75,366,366,500
72,71,75,71,77,366,366,500
74,77,76,70,76,373,373,500
72,74,71,77,78,372,372,500
77,73,71,74,72,367,367,500
72,76,78,76,75,377,377,500
75,71,76,72,75,369,369,500
73,73,77,77,76,376,376,500
77,70,74,70,71,362,362,500
75,70,75,76,74,370,370,500
72,70,77,70,77,366,366,500
76,72,73,70,73,364,364,500
78,71,71,76,78,374,374,500
77,71,72,76,75,371,371,500
70,75,71,72,75,363,363,500
76,78,70,73,76,373,373,500
74,72,73,76,77,372,372,500
70,76,73,73,71,363,363,500
73,76,75,75,72,371,371,500
77,72,78,73,78,378,378,500
78,76,72,71,73,370,370,500
76,75,78,70,75,374,374,500
78,74,71,74,75,372,372,500
77,77,70,77,71,372,372,500
78,72,77,73,74,374,374,500
74,70,78,71,70,363,363,500
78,71,72,72,72,365,365,500
76,75,70,71,76,368,368,500
77,78,72,77,74,378,378,500
73,74,71,72,72,362,362,500
75,74,76,72,74,371,371,500
76,77,72,70,70,365,365,500
70,72,74,73,70,359,359,500
74,78,75,73,74,374,374,500
73,71,75,71,73,363,363,500
75,70,73,72,71,361,361,500
75,74,72,71,74,366,366,500
74,75,73,76,75,373,373,500
75,70,76,78,73,372,372,500
71,70,71,77,76,365,365,500
77,76,76,73,77,379,379,500
70,73,74,78,74,369,369,500
75,78,72,73,73,371,371,500
78,77,72,78,78,383,383,500
78,75,73,70,75,371,371,500
77,72,75,72,72,368,368,500
74,75,72,77,72,370,370,500
71,71,71,71,74,358,358,500
78,72,72,75,72,369,369,500
71,78,76,70,77,372,372,500
74,77,74,72,77,374,374,500
72,73,74,77,76,372,372,500
78,75,72,73,75,373,373,500
78,74,78,77,74,381,381,500
71,76,77,70,72,366,366,500
70,78,76,76,78,378,378,500
71,70,75,72,76,364,364,500
72,78,71,73,72,366,366,500
77,77,70,74,75,373,373,500
76,75,74,78,71,374,374,500
70,73,75,70,77,365,365,500
76,77,70,72,77,372,372,500
74,73,75,77,78,377,377,500
78,70,78,77,76,379,379,500
75,71,73,74,76,369,369,500
72,73,70,75,71,361,361,500
78,72,71,70,75,366,366,500
76,70,76,71,77,370,370,500
73,78,71,74,72,368,368,500
73,71,76,75,74,369,369,500
73,77,72,72,74,368,368,500
78,75,70,78,77,378,378,500
75,71,75,73,78,372,372,500
77,74,71,71,72,365,365,500
72,74,77,70,74,367,367,500
73,76,74,78,78,379,379,500
76,71,70,72,70,359,359,500
78,73,74,74,77,376,376,500
70,72,70,76,71,359,359,500
70,77,74,78,77,376,376,500
78,76,73,70,74,371,371,500
78,72,77,76,71,374,374,500
73,72,77,76,71,369,369,500
76,77,76,72,73,374,374,500
78,70,77,75,76,376,376,500
75,71,70,74,78,368,368,500
78,76,77,76,78,385,385,500
77,72,78,70,72,369,369,500
76,71,73,76,70,366,366,500
71,78,71,71,75,366,366,500
75,77,72,72,73,369,369,500
76,70,72,76,73,367,367,500
74,78,76,71,78,377,377,500
77,77,70,70,74,368,368,500
78,72,74,74,75,373,373,500
74,78,73,71,77,373,373,500
71,72,71,72,77,363,363,500
77,78,76,71,77,379,379,500
75,76,74,71,73,369,369,500
74,77,72,74,74,371,371,500
71,71,72,76,73,363,363,500
73,70,74,77,73,367,367,500
70,75,77,70,76,368,368,500
78,75,70,70,72,365,365,500
70,78,74,78,70,370,370,500
76,74,70,75,77,372,372,500
72,70,75,73,78,368,368,500
74,70,77,73,70,364,364,500
77,70,75,78,76,376,376,500
73,72,77,71,77,370,370,500
76,78,70,76,75,375,375,500
76,70,71,73,76,366,366,500
75,76,75,76,72,374,374,500
74,71,73,75,71,364,364,500
71,76,73,76,70,366,366,500
70,70,78,71,76,365,365,500
71,76,74,78,77,376,376,500
75,70,71,77,73,366,366,500
74,73,76,74,78,375,375,500
78,73,72,74,70,367,367,500
70,71,77,75,78,371,371,500
78,75,78,74,78,383,383,500
72,70,72,77,70,361,361,500
77,76,71,71,71,366,366,500
76,71,77,74,76,374,374,500
76,76,71,70,70,363,363,500
78,72,76,75,71,372,372,500
76,70,73,78,71,368,368,500
72,76,70,75,72,365,365,500
78,75,71,77,77,378,378,500
73,70,78,70,75,366,366,500
76,74,72,76,71,369,369,500
73,72,75,75,76,371,371,500
74,71,73,70,73,361,361,500
72,75,76,73,73,369,369,500
76,77,74,70,75,372,372,500
76,75,75,73,70,369,369,500
73,76,78,70,78,375,375,500
78,70,76,71,72,367,367,500
77,71,72,78,70,368,368,500
77,76,78,72,76,379,379,500
73,76,70,72,70,361,361,500
78,77,75,73,77,380,380,500
70,75,78,74,78,375,375,500
76,76,75,73,72,372,372,500
73,77,75,72,74,371,371,500
70,70,70,75,74,359,359,500
76,70,78,72,74,370,370,500
71,78,72,78,73,372,372,500
75,76,78,71,73,373,373,500
78,72,73,77,77,377,377,500
75,78,72,71,78,374,374,500
77,74,71,75,77,374,374,500
71,73,70,74,72,360,360,500
72,70,72,72,77,363,363,500
74,70,72,75,78,369,369,500
73,77,78,70,76,374,374,500
73,73,75,71,75,367,367,500
70,75,75,74,70,364,364,500
72,74,72,72,74,364,364,500
78,75,70,73,76,372,372,500
71,75,77,78,71,372,372,500
75,73,71,73,74,366,366,500
71,70,75,76,75,367,367,500
72,72,77,71,78,370,370,500
72,75,73,71,72,363,363,500
73,77,73,73,77,373,373,500
78,76,71,77,76,378,378,500
73,76,77,70,74,370,370,500
72,76,76,77,73,374,374,500
76,72,70,77,75,370,370,500
77,73,77,74,74,375,375,500
74,78,74,70,71,367,367,500
72,71,77,71,77,368,368,500
73,73,74,74,74,368,368,500
74,78,75,72,73,372,372,500
71,78,77,71,71,368,368,500
75,70,74,74,72,365,365,500
78,78,78,78,77,389,389,500
71,72,74,78,75,370,370,500
70,74,74,75,76,369,369,500
75,74,72,78,74,373,373,500
76,72,76,70,70,364,364,500
71,72,70,70,73,356,356,500
76,74,70,71,73,364,364,500
76,72,72,75,73,368,368,500
73,75,71,70,70,359,359,500
75,70,71,77,78,371,371,500
77,70,72,74,77,370,370,500
78,77,75,77,75,382,382,500
76,71,75,76,76,374,374,500
72,76,78,76,74,376,376,500
73,74,74,74,70,365,365,500
72,77,75,70,76,370,370,500
75,76,78,70,76,375,375,500
70,70,70,72,73,355,355,500
74,74,73,70,77,368,368,500
77,74,75,75,71,372,372,500
74,77,73,73,78,375,375,500
76,78,78,74,77,383,383,500
75,74,70,71,75,365,365,500
74,74,76,70,75,369,369,500
73,77,75,77,76,378,378,500
78,72,70,73,70,363,363,500
70,75,78,77,78,378,378,500
78,76,76,74,77,381,381,500
70,78,75,76,76,375,375,500
73,71,72,78,77,371,371,500
77,76,71,73,73,370,370,500
70,70,75,77,77,369,369,500
72,74,74,78,78,376,376,500
74,75,75,70,72,366,366,500
72,73,78,77,77,377,377,500
71,74,70,71,74,360,360,500
71,72,71,73,78,365,365,500
72,76,70,76,71,365,365,500
70,70,74,76,71,361,361,500
71,73,74,72,72,362,362,500
76,78,73,72,73,372,372,500
75,74,74,71,76,370,370,500
70,74,73,78,73,368,368,500
77,70,70,72,78,367,367,500
73,74,78,73,76,374,374,500
78,77,78,73,70,376,376,500
74,72,75,74,74,369,369,500
77,76,70,77,70,370,370,500
76,73,76,70,71,366,366,500
77,75,78,78,77,385,385,500
73,71,76,73,71,364,364,500
70,74,78,76,74,372,372,500
70,75,74,75,72,366,366,500
70,75,75,77,75,372,372,500
77,75,76,75,71,374,374,500
70,72,74,72,76,364,364,500
73,75,70,70,73,361,361,500
70,73,75,78,75,371,371,500
74,76,73,77,78,378,378,500
77,77,78,75,70,377,377,500
71,76,72,70,76,365,365,500
73,72,75,71,73,364,364,500
71,78,71,73,73,366,366,500
75,78,72,70,77,372,372,500
73,78,70,77,76,374,374,500
77,76,74,74,74,375,375,500
74,73,78,71,73,369,369,500
72,71,72,76,77,368,368,500
75,71,71,73,76,366,366,500
76,70,76,73,74,369,369,500
72,73,74,70,72,361,361,500
70,78,76,70,78,372,372,500
71,74,70,72,73,360,360,500
71,72,70,72,77,362,362,500
74,70,70,71,71,356,356,500
73,77,77,71,71,369,369,500
73,73,75,77,73,371,371,500
73,71,74,75,72,365,365,500
74,72,78,71,70,365,365,500
73,70,70,77,70,360,360,500
71,74,73,71,73,362,362,500
71,78,75,78,73,375,375,500
72,73,75,70,74,364,364,500
70,70,73,70,77,360,360,500
72,78,75,78,71,374,374,500
72,70,76,78,72,368,368,500
74,75,70,76,72,367,367,500
73,78,70,77,78,376,376,500
78,78,72,75,77,380,380,500
74,77,74,75,72,372,372,500
76,77,74,70,71,368,368,500
74,73,73,74,77,371,371,500
78,74,72,77,72,373,373,500
70,77,71,77,77,372,372,500
71,77,75,74,70,367,367,500
71,77,73,76,72,369,369,500
73,70,78,73,74,368,368,500
72,72,74,70,78,366,366,500
75,73,71,72,71,362,362,500
78,72,76,74,70,370,370,500
78,73,73,74,77,375,375,500
75,74,78,71,78,376,376,500
72,71,72,75,72,362,362,500
77,75,77,77,71,377,377,500
76,74,70,78,77,375,375,500
73,78,72,72,72,367,367,500
72,76,70,71,78,367,367,500
76,72,77,76,78,379,379,500
73,74,75,72,77,371,371,500
72,78,77,75,77,379,379,500
74,76,70,74,75,369,369,500
71,71,70,70,78,360,360,500
72,78,76,74,74,374,374,500
75,74,71,74,71,365,365,500
76,72,72,73,73,366,366,500
71,72,77,70,76,366,366,500
78,74,75,74,74,375,375,500
77,78,74,71,78,378,378,500
78,71,72,73,74,368,368,500
78,78,74,70,75,375,375,500
76,74,78,71,72,371,371,500
70,71,71,78,74,364,364,500
74,72,78,72,77,373,373,500
77,76,77,77,72,379,379,500
75,78,72,70,73,368,368,500
73,77,73,75,78,376,376,500
74,71,78,73,70,366,366,500
76,70,74,71,78,369,369,500
78,76,72,73,75,374,374,500
71,71,75,75,71,363,363,500
77,75,78,73,75,378,378,500
73,73,77,73,72,368,368,500
72,78,73,70,74,367,367,500
75,75,76,76,74,376,376,500
71,76,75,77,70,369,369,500
72,76,73,73,77,371,371,500
76,75,75,74,70,370,370,500
77,73,75,74,77,376,376,500
72,78,75,72,78,375,375,500
71,75,75,72,75,368,368,500
73,71,77,75,76,372,372,500
76,77,75,70,74,372,372,500
70,78,76,71,74,369,369,500
77,78,76,70,75,376,376,500
76,77,76,70,70,369,369,500
71,71,76,77,70,365,365,500
78,77,78,74,73,380,380,500
72,78,73,76,71,370,370,500
77,72,78,73,74,374,374,500
73,71,75,75,71,365,365,500
75,78,76,73,70,372,372,500
74,71,73,75,76,369,369,500
76,70,74,77,75,372,372,500
77,72,72,70,71,362,362,500
78,70,78,77,73,376,376,500
77,73,70,78,73,371,371,500
75,72,75,72,77,371,371,500
75,74,78,72,71,370,370,500
77,77,77,78,76,385,385,500
77,78,71,75,78,379,379,500
71,76,76,75,73,371,371,500
72,78,75,70,76,371,371,500
76,71,72,78,70,367,367,500
71,70,70,77,78,366,366,500
74,77,70,77,72,370,370,500
71,75,77,71,76,370,370,500
70,71,74,78,73,366,366,500
70,72,70,77,72,361,361,500
75,73,73,72,70,363,363,500
75,74,74,70,76,369,369,500
70,70,75,73,78,366,366,500
73,73,74,76,75,371,371,500
76,73,77,73,73,372,372,500
74,77,75,76,77,379,379,500
78,76,73,73,70,370,370,500
78,71,73,72,72,366,366,500
70,71,71,70,77,359,359,500
77,72,78,73,74,374,374,500
74,73,76,70,78,371,371,500
71,77,72,76,70,366,366,500
74,75,71,74,74,368,368,500
77,78,73,74,73,375,375,500
78,70,71,75,70,364,364,500
70,76,73,71,72,362,362,500
73,77,77,70,71,368,368,500
73,78,74,74,75,374,374,500
70,73,78,72,78,371,371,500
77,70,77,70,71,365,365,500
74,78,72,76,70,370,370,500
77,75,72,72,70,366,366,500
77,78,74,71,73,373,373,500
72,77,77,75,75,376,376,500
77,77,77,72,76,379,379,500
70,72,70,73,72,357,357,500
70,78,73,77,72,370,370,500
70,78,78,76,70,372,372,500
77,78,70,72,78,375,375,500
75,75,75,72,77,374,374,500
75,72,76,73,74,370,370,500
73,72,72,75,74,366,366,500
74,70,72,75,72,363,363,500
72,76,73,70,73,364,364,500
78,75,74,75,73,375,375,500
70,75,78,70,72,365,365,500
75,76,71,74,78,374,374,500
72,76,77,73,73,371,371,500
73,78,74,75,75,375,375,500
74,71,74,76,77,372,372,500
70,75,70,78,75,368,368,500
70,70,78,75,76,369,369,500
76,77,74,70,70,367,367,500
73,78,72,70,74,367,367,500
71,72,74,70,76,363,363,500
74,76,71,73,72,366,366,500
73,76,76,75,78,378,378,500
72,73,76,70,70,361,361,500
76,75,75,75,75,376,376,500
78,73,72,72,75,370,370,500
73,71,72,70,71,357,357,500
73,75,71,77,78,374,374,500
71,73,71,77,72,364,364,500
75,75,70,73,76,369,369,500
75,75,76,75,74,375,375,500
71,77,77,72,72,369,369,500
77,78,77,78,73,383,383,500
77,74,75,72,70,368,368,500
74,77,73,73,72,369,369,500
70,70,74,70,70,354,354,500
72,78,74,77,78,379,379,500
70,73,72,76,74,365,365,500
76,73,74,72,75,370,370,500
74,72,77,76,77,376,376,500
74,73,74,74,77,372,372,500
71,74,73,73,72,363,363,500
71,73,71,72,70,357,357,500
77,74,71,72,72,366,366,500
77,75,73,77,70,372,372,500
76,73,70,70,73,362,362,500
77,74,73,72,71,367,367,500
70,75,71,75,70,361,361,500
75,71,71,73,70,360,360,500
76,70,76,77,77,376,376,500
78,74,70,72,72,366,366,500
71,71,76,73,74,365,365,500
74,77,72,72,76,371,371,500
70,71,70,78,78,367,367,500
74,71,74,77,78,374,374,500
77,78,74,72,75,376,376,500
70,75,77,70,71,363,363,500
76,72,78,72,74,372,372,500
72,71,72,74,78,367,367,500
74,73,70,72,75,364,364,500
72,75,71,70,70,358,358,500
77,73,75,74,70,369,369,500
73,71,74,76,70,364,364,500
78,75,77,72,71,373,373,500
77,72,77,71,73,370,370,500
78,74,70,77,77,376,376,500
77,72,75,77,74,375,375,500
75,73,73,71,77,369,369,500
71,76,72,74,74,367,367,500
71,71,74,75,78,369,369,500
73,78,71,70,74,366,366,500
78,75,75,78,75,381,381,500
76,74,73,72,72,367,367,500
71,74,75,75,74,369,369,500
73,73,78,74,72,370,370,500
72,78,71,74,72,367,367,500
77,73,78,74,78,380,380,500
76,75,72,76,71,370,370,500
71,77,76,76,75,375,375,500
77,77,72,78,72,376,376,500
72,76,77,75,74,374,374,500
70,76,75,72,73,366,366,500
72,75,77,72,75,371,371,500
70,76,71,72,71,360,360,500
76,75,72,75,75,373,373,500
76,73,71,75,75,370,370,500
73,70,71,76,75,365,365,500
75,72,77,77,71,372,372,500
71,73,75,75,76,370,370,500
74,75,77,70,71,367,367,500
78,72,74,78,76,378,378,500
74,74,74,70,71,363,363,500
71,75,71,76,71,364,364,500
77,75,76,77,78,383,383,500
70,71,71,72,78,362,362,500
77,77,77,71,77,379,379,500
70,75,70,72,75,362,362,500
74,78,77,73,78,380,380,500
76,71,76,70,70,363,363,500
77,78,71,78,75,379,379,500
70,76,72,76,72,366,366,500
72,73,74,77,74,370,370,500
73,76,74,77,75,375,375,500
77,78,71,75,77,378,378,500
73,73,76,74,78,374,374,500
73,76,76,74,72,371,371,500
71,76,72,71,74,364,364,500
71,76,73,72,75,367,367,500
73,75,76,70,73,367,367,500
78,76,78,72,76,380,380,500
75,76,72,75,71,369,369,500
75,73,73,71,75,367,367,500
73,72,75,72,70,362,362,500
77,72,75,73,77,374,374,500
76,76,70,74,75,371,371,500
72,72,78,71,74,367,367,500
71,70,70,75,77,363,363,500
75,75,70,77,78,375,375,500
73,71,78,73,70,365,365,500
77,77,75,71,75,375,375,500
73,75,71,75,76,370,370,500
78,73,75,72,76,374,374,500
72,74,78,70,71,365,365,500
72,75,71,72,77,367,367,500
72,75,78,72,75,372,372,500
76,78,78,73,78,383,383,500
71,73,76,71,77,368,368,500
76,70,76,76,78,376,376,500
76,72,78,76,77,379,379,500
75,72,78,70,70,365,365,500
78,70,76,72,73,369,369,500
76,71,76,73,76,372,372,500
77,77,71,77,73,375,375,500
73,77,78,71,76,375,375,500
70,75,75,75,76,371,371,500
76,74,73,73,78,374,374,500
70,72,72,78,77,369,369,500
78,77,78,76,71,380,380,500
70,71,72,73,75,361,361,500
71,70,73,74,72,360,360,500
76,70,71,70,75,362,362,500
78,76,73,77,71,375,375,500
76,72,74,70,76,368,368,500
74,72,75,76,71,368,368,500
70,71,73,71,71,356,356,500
76,76,78,76,76,382,382,500
76,75,72,74,72,369,369,500
74,73,75,78,73,373,373,500
78,77,77,76,72,380,380,500
73,75,74,70,74,366,366,500
71,73,77,74,73,368,368,500
73,70,78,78,72,371,371,500
76,71,75,78,71,371,371,500
78,72,76,72,74,372,372,500
76,78,75,77,77,383,383,500
77,70,73,71,78,369,369,500
78,70,73,77,70,368,368,500
72,78,77,77,76,380,380,500
74,71,72,77,74,368,368,500
74,78,76,76,77,381,381,500
75,71,70,76,77,369,369,500
74,70,76,77,71,368,368,500
72,73,73,71,78,367,367,500
72,72,75,73,71,363,363,500
70,73,77,70,71,361,361,500
76,75,70,75,77,373,373,500
75,75,77,74,77,378,378,500
77,70,74,74,73,368,368,500
78,72,74,71,76,371,371,500
74,71,71,78,70,364,364,500
76,71,72,74,77,370,370,500
76,78,77,74,73,378,378,500
77,75,75,70,71,368,368,500
77,78,75,78,77,385,385,500
71,78,70,74,70,363,363,500
76,78,77,76,73,380,380,500
76,71,71,71,72,361,361,500
72,76,72,76,74,370,370,500
77,77,71,76,76,377,377,500
72,71,70,78,72,363,363,500
76,74,73,77,72,372,372,500
73,72,73,71,78,367,367,500
72,71,72,70,71,356,356,500
73,77,77,77,75,379,379,500
73,73,74,74,77,371,371,500
78,72,74,76,76,376,376,500
74,71,71,72,74,362,362,500
74,74,75,73,78,374,374,500
72,77,75,76,71,371,371,500
72,78,72,72,76,370,370,500
78,76,70,71,76,371,371,500
73,76,70,71,78,368,368,500
78,77,77,74,71,377,377,500
78,77,76,70,75,376,376,500
73,72,78,71,76,370,370,500
76,71,73,70,77,367,367,500
74,74,73,76,76,373,373,500
72,75,71,78,74,370,370,500
72,73,78,72,74,369,369,500
72,77,77,75,70,371,371,500
71,70,74,75,74,364,364,500
72,74,74,76,76,372,372,500
78,78,74,71,75,376,376,500
70,70,73,70,75,358,358,500
77,73,71,73,77,371,371,500
72,78,78,76,74,378,378,500
71,72,71,73,74,361,361,500
77,75,76,74,76,378,378,500
76,70,71,71,70,358,358,500
75,76,76,74,76,377,377,500
71,76,73,74,71,365,365,500
72,70,70,73,72,357,357,500
71,77,71,76,70,365,365,500
72,75,73,78,73,371,371,500
74,72,71,72,75,364,364,500
72,70,78,74,72,366,366,500
76,71,77,72,78,374,374,500
72,78,72,74,76,372,372,500
71,70,73,74,74,362,362,500
78,76,72,76,70,372,372,500
71,77,71,76,78,373,373,500
71,78,70,72,70,361,361,500
76,77,78,78,74,383,383,500
72,71,75,75,78,371,371,500
74,75,73,76,74,372,372,500
75,77,75,70,71,368,368,500
73,77,71,71,70,362,362,500
76,77,75,77,78,383,383,500
75,71,71,78,75,370,370,500
75,72,76,74,76,373,373,500
75,73,78,72,77,375,375,500
73,78,77,71,71,370,370,500
70,76,78,78,76,378,378,500
75,75,70,72,71,363,363,500
72,74,74,75,73,368,368,500
73,70,77,78,71,369,369,500
70,75,74,72,76,367,367,500
72,70,72,71,74,359,359,500
73,77,70,71,70,361,361,500
72,70,73,70,73,358,358,500
73,77,75,78,76,379,379,500
70,73,75,72,78,368,368,500
78,73,76,72,74,373,373,500
77,72,76,78,74,377,377,500
74,70,78,78,78,378,378,500
71,77,76,70,72,366,366,500
76,70,74,76,78,374,374,500
73,77,76,70,76,372,372,500
76,71,75,75,76,373,373,500
73,75,76,75,75,374,374,500
78,77,73,72,70,370,370,500
78,73,77,75,70,373,373,500
70,73,70,76,78,367,367,500
70,73,72,75,76,366,366,500
72,76,71,78,76,373,373,500
76,75,72,71,78,372,372,500
71,78,77,70,77,373,373,500
73,70,70,70,74,357,357,500
74,70,72,74,74,364,364,500
71,75,78,74,78,376,376,500
78,76,73,73,72,372,372,500
76,75,73,70,73,367,367,500
75,74,73,73,73,368,368,500
73,78,75,75,78,379,379,500
73,72,75,78,72,370,370,500
70,77,71,75,78,371,371,500
75,77,72,73,70,367,367,500
70,75,71,74,74,364,364,500
78,78,73,76,72,377,377,500
70,72,73,74,71,360,360,500
78,77,74,75,72,376,376,500
78,75,71,74,76,374,374,500
75,73,73,73,72,366,366,500
71,78,77,73,78,377,377,500
77,76,77,78,72,380,380,500
75,76,73,75,73,372,372,500
70,77,75,74,77,373,373,500
75,70,77,76,78,376,376,500
72,71,76,75,75,369,369,500
78,73,70,76,74,371,371,500
78,77,72,74,70,371,371,500
74,77,76,78,78,383,383,500
71,76,70,71,75,363,363,500
75,73,73,70,78,369,369,500
74,76,74,74,71,369,369,500
76,76,75,77,74,378,378,500
73,74,76,72,72,367,367,500
72,78,75,78,70,373,373,500
77,71,70,76,73,367,367,500
75,75,77,73,78,378,378,500
72,73,73,78,71,367,367,500
70,76,71,76,74,367,367,500
76,75,77,71,74,373,373,500
76,73,71,78,76,374,374,500
75,78,77,73,72,375,375,500
76,71,73,74,78,372,372,500
77,72,71,70,74,364,364,500
78,76,78,70,73,375,375,500
77,75,76,73,77,378,378,500
74,74,73,78,75,374,374,500
73,78,78,72,70,371,371,500
78,73,72,72,78,373,373,500
71,72,75,77,76,371,371,500
73,70,77,78,72,370,370,500
76,70,75,70,78,369,369,500
73,73,70,72,73,361,361,500
75,74,78,73,70,370,370,500
75,72,78,77,74,376,376,500
72,78,70,77,70,367,367,500
76,72,76,71,71,366,366,500
70,75,78,76,71,370,370,500
73,77,70,71,74,365,365,500
74,73,74,71,74,366,366,500
70,72,73,71,75,361,361,500
74,70,77,70,76,367,367,500
76,75,70,78,78,377,377,500
71,70,76,71,78,366,366,500
73,71,73,72,76,365,365,500
74,73,78,73,71,369,369,500
71,70,78,73,75,367,367,500
72,76,70,73,77,368,368,500
76,73,77,73,78,377,377,500
76,74,76,72,75,373,373,500
73,71,73,78,77,372,372,500
71,78,76,72,70,367,367,500
71,77,75,77,77,377,377,500
76,70,72,77,77,372,372,500
76,71,71,76,70,364,364,500
71,77,73,74,73,368,368,500
70,78,78,77,78,381,381,500
76,70,77,72,76,371,371,500
72,78,70,71,72,363,363,500
77,77,75,71,71,371,371,500
72,73,72,73,77,367,367,500
74,76,77,72,71,370,370,500
74,72,74,78,74,372,372,500
76,73,71,70,72,362,362,500
74,71,76,76,77,374,374,500
76,70,71,71,77,365,365,500
71,74,73,73,74,365,365,500
70,72,78,76,78,374,374,500
73,72,77,70,72,364,364,500
73,74,74,71,73,365,365,500
71,72,73,76,77,369,369,500
73,70,70,74,77,364,364,500
76,77,71,76,72,372,372,500
77,72,73,71,74,367,367,500
71,71,77,73,75,367,367,500
77,74,74,74,75,374,374,500
75,73,78,77,78,381,381,500
72,77,75,77,71,372,372,500
77,72,77,78,73,377,377,500
75,71,73,78,73,370,370,500
75,73,73,74,75,370,370,500
76,77,78,78,78,387,387,500
72,76,78,78,70,374,374,500
77,71,78,75,71,372,372,500
75,75,73,76,70,369,369,500
77,76,78,73,70,374,374,500
74,73,74,76,77,374,374,500
71,70,74,72,70,357,357,500
73,76,75,76,72,372,372,500
75,73,70,76,78,372,372,500
77,75,76,75,73,376,376,500
76,78,71,73,70,368,368,500
71,70,70,72,75,358,358,500
74,74,72,77,75,372,372,500
73,71,76,73,76,369,369,500
72,70,75,72,73,362,362,500
70,72,76,71,78,367,367,500
78,74,73,76,74,375,375,500
70,73,74,72,74,363,363,500
77,76,74,70,70,367,367,500
70,74,70,71,72,357,357,500
73,71,76,72,75,367,367,500
75,71,78,73,76,373,373,500
73,75,73,74,76,371,371,500
73,73,78,77,74,375,375,500
77,74,74,77,75,377,377,500
78,75,75,77,73,378,378,500
70,78,71,72,70,361,361,500
76,71,73,78,74,372,372,500
73,71,74,73,71,362,362,500
74,78,70,72,71,365,365,500
77,76,73,73,75,374,374,500
75,76,74,72,73,370,370,500
73,76,78,70,75,372,372,500
77,75,70,78,71,371,371,500
78,78,75,73,76,380,380,500
75,76,74,74,70,369,369,500
70,71,72,70,72,355,355,500
74,71,71,74,74,364,364,500
76,75,74,75,73,373,373,500
78,70,70,76,73,367,367,500
73,75,72,72,71,363,363,500
70,76,77,75,77,375,375,500
75,78,72,73,77,375,375,500
76,72,74,75,78,375,375,500
74,73,77,76,70,370,370,500
72,75,70,70,72,359,359,500
74,72,72,72,70,360,360,500
75,77,78,77,74,381,381,500
76,74,72,76,70,368,368,500
76,70,72,71,75,364,364,500
75,74,72,72,76,369,369,500
76,72,77,75,73,373,373,500
71,71,76,77,72,367,367,500
74,71,77,73,76,371,371,500
71,71,71,70,73,356,356,500
73,75,72,70,73,363,363,500
77,70,77,71,75,370,370,500
78,78,76,77,71,380,380,500
75,72,75,74,73,369,369,500
78,77,70,72,72,369,369,500
75,70,77,76,70,368,368,500
76,73,72,71,73,365,365,500
70,76,73,70,77,366,366,500
70,74,78,77,73,372,372,500
74,70,71,70,74,359,359,500
72,70,75,71,72,360,360,500
74,70,71,77,74,366,366,500
78,77,78,71,71,375,375,500
74,72,71,73,75,365,365,500
77,76,73,70,77,373,373,500
73,73,74,74,76,370,370,500
73,76,70,71,70,360,360,500
77,75,77,77,76,382,382,500
75,76,77,75,75,378,378,500
73,75,73,73,78,372,372,500
78,71,70,72,78,369,369,500
74,73,73,77,70,367,367,500
76,74,75,71,75,371,371,500
70,75,72,70,75,362,362,500
72,71,72,73,76,364,364,500
74,75,72,78,71,370,370,500
77,73,74,72,78,374,374,500
71,73,78,70,73,365,365,500
73,78,74,78,71,374,374,500
70,73,76,71,73,363,363,500
72,73,78,70,72,365,365,500
78,77,73,77,73,378,378,500
70,72,75,71,71,359,359,500
78,70,77,74,74,373,373,500
74,71,74,77,70,366,366,500
74,74,74,73,74,369,369,500
75,76,76,76,74,377,377,500
74,74,77,76,73,374,374,500
75,71,78,75,72,371,371,500
73,70,71,71,70,355,355,500
70,73,73,70,76,362,362,500
76,74,74,71,71,366,366,500
74,73,74,76,70,367,367,500
73,73,73,71,75,365,365,500
76,71,70,74,75,366,366,500
76,77,75,70,76,374,374,500
74,78,76,78,75,381,381,500
76,71,75,75,76,373,373,500
76,76,78,78,74,382,382,500
73,74,74,76,77,374,374,500
78,76,73,78,73,378,378,500
78,71,78,76,76,379,379,500
71,78,73,76,71,369,369,500
74,73,72,74,78,371,371,500
76,70,70,76,73,365,365,500
70,75,73,77,71,366,366,500
72,75,73,78,73,371,371,500
71,72,72,75,78,368,368,500
73,74,71,75,78,371,371,500
77,71,74,73,72,367,367,500
76,71,74,72,74,367,367,500
72,77,78,71,77,375,375,500
75,72,75,72,74,368,368,500
75,76,76,76,77,380,380,500
73,76,76,72,76,373,373,500
74,73,72,73,75,367,367,500
77,77,74,70,73,371,371,500
74,74,73,77,77,375,375,500
74,71,71,78,70,364,364,500
73,78,73,77,71,372,372,500
74,78,77,72,71,372,372,500
75,72,74,74,72,367,367,500
74,72,71,73,70,360,360,500
72,71,72,72,71,358,358,500
72,74,70,77,75,368,368,500
70,76,78,74,75,373,373,500
70,78,70,75,74,367,367,500
74,76,75,74,77,376,376,500
71,74,72,77,76,370,370,500
70,75,72,73,78,368,368,500
76,75,75,78,74,378,378,500
76,70,70,70,70,356,356,500
76,75,77,72,77,377,377,500
74,74,74,72,75,369,369,500
71,72,75,72,72,362,362,500
71,73,73,71,76,364,364,500
75,73,74,71,77,370,370,500
77,74,74,70,76,371,371,500
74,71,76,70,71,362,362,500
70,71,72,70,70,353,353,500
77,78,73,78,74,380,380,500
74,78,73,78,77,380,380,500
74,71,75,72,76,368,368,500
77,74,77,78,76,382,382,500
72,77,72,78,78,377,377,500
73,70,72,75,71,361,361,500
70,74,75,75,74,368,368,500
75,74,71,78,76,374,374,500
73,75,73,76,76,373,373,500
71,78,72,71,71,363,363,500
76,70,78,77,72,373,373,500
71,77,72,76,74,370,370,500
72,72,70,73,74,361,361,500
77,72,72,78,74,373,373,500
72,77,71,71,70,361,361,500
78,73,74,73,73,371,371,500
71,71,77,74,71,364,364,500
71,75,73,73,78,370,370,500
76,72,70,75,77,370,370,500
74,73,78,75,75,375,375,500
75,73,76,75,78,377,377,500
73,77,74,77,70,371,371,500
74,78,73,71,71,367,367,500
70,78,75,78,71,372,372,500
73,76,76,73,74,372,372,500
78,71,74,73,72,368,368,500
70,78,72,74,74,368,368,500
70,74,77,73,72,366,366,500
70,71,71,77,71,360,360,500
78,73,72,72,73,368,368,500
77,71,77,71,74,370,370,500
74,73,74,72,78,371,371,500
72,71,78,72,71,364,364,500
74,78,70,71,76,369,369,500
73,76,71,77,70,367,367,500
78,75,71,73,73,370,370,500
75,74,77,78,77,381,381,500
77,75,75,78,77,382,382,500
70,70,75,77,78,370,370,500
70,74,76,76,71,367,367,500
72,71,78,75,77,373,373,500
73,77,72,78,70,370,370,500
71,74,74,74,77,370,370,500
75,71,72,76,76,370,370,500
70,72,71,76,73,362,362,500
70,73,72,71,75,361,361,500
75,78,71,72,74,370,370,500
75,77,71,71,77,371,371,500
75,72,77,78,76,378,378,500
71,73,74,73,72,363,363,500
76,75,77,77,71,376,376,500
76,75,78,78,76,383,383,500
77,74,78,71,77,377,377,500
76,70,77,71,71,365,365,500
75,72,75,77,78,377,377,500
78,74,74,75,78,379,379,500
76,77,72,73,77,375,375,500
75,73,77,77,74,376,376,500
73,78,77,74,78,380,380,500
70,74,72,76,70,362,362,500
72,78,72,78,76,376,376,500
71,72,77,78,77,375,375,500
71,77,74,71,78,371,371,500
75,71,71,72,74,363,363,500
70,73,76,71,73,363,363,500
76,78,78,78,75,385,385,500
70,77,78,71,73,369,369,500
76,71,70,71,71,359,359,500
71,72,75,73,71,362,362,500
72,76,76,71,74,369,369,500
76,74,77,72,72,371,371,500
73,72,70,75,76,366,366,500
70,71,71,78,76,366,366,500
77,72,72,71,77,369,369,500
72,76,72,76,70,366,366,500
73,78,76,71,73,371,371,500
77,77,75,76,71,376,376,500
73,78,71,77,78,377,377,500
73,76,72,77,77,375,375,500
73,77,71,73,78,372,372,500
70,75,70,78,75,368,368,500
75,74,76,77,76,378,378,500
70,78,78,70,75,371,371,500
75,71,75,72,70,363,363,500
71,78,76,72,71,368,368,500
72,77,71,73,74,367,367,500
78,73,75,75,71,372,372,500
71,71,72,76,74,364,364,500
78,70,73,78,72,371,371,500
77,72,70,70,70,359,359,500
76,73,75,70,74,368,368,500
71,70,73,77,71,362,362,500
70,74,72,74,76,366,366,500
77,70,73,78,75,373,373,500
71,77,73,74,74,369,369,500
73,71,72,77,71,364,364,500
70,71,73,74,70,358,358,500
73,73,76,72,78,372,372,500
78,70,76,70,70,364,364,500
72,76,70,77,74,369,369,500
76,73,70,74,77,370,370,500
71,77,78,76,72,374,374,500
70,76,78,77,72,373,373,500
72,78,72,75,74,371,371,500
77,73,74,73,74,371,371,500
77,75,75,76,73,376,376,500
78,71,72,78,75,374,374,500
78,76,75,73,73,375,375,500
74,74,75,77,74,374,374,500
77,72,73,74,78,374,374,500
73,76,72,78,73,372,372,500
75,70,74,76,73,368,368,500
76,74,78,74,75,377,377,500
74,70,75,77,74,370,370,500
73,72,71,78,75,369,369,500
78,75,76,72,74,375,375,500
70,77,75,71,72,365,365,500
70,73,74,70,70,357,357,500
77,74,73,70,77,371,371,500
72,75,77,78,72,374,374,500
75,74,72,75,78,374,374,500
71,76,75,72,71,365,365,500
71,73,78,71,78,371,371,500
73,71,71,70,74,359,359,500
72,73,72,77,70,364,364,500
70,77,72,70,74,363,363,500
74,74,75,70,77,370,370,500
74,73,74,70,70,361,361,500
77,71,71,71,73,363,363,500
71,72,76,72,75,366,366,500
75,77,76,71,78,377,377,500
76,75,75,78,71,375,375,500
78,76,71,74,74,373,373,500
75,77,70,78,77,377,377,500
77,76,77,75,71,376,376,500
76,75,77,74,74,376,376,500
71,70,73,73,73,360,360,500
72,73,74,70,76,365,365,500
72,76,78,70,74,370,370,500
71,76,77,78,73,375,375,500
72,70,71,76,73,362,362,500
73,71,72,78,71,365,365,500
72,78,70,77,76,373,373,500
78,72,72,72,72,366,366,500
74,78,71,73,71,367,367,500
76,72,74,78,78,378,378,500
71,75,76,75,71,368,368,500
77,70,75,74,76,372,372,500
77,77,77,76,76,383,383,500
77,73,72,71,73,366,366,500
75,75,73,74,74,371,371,500
74,72,78,73,73,370,370,500
72,75,74,75,70,366,366,500
71,77,77,75,72,372,372,500
75,72,78,74,78,377,377,500
72,74,71,70,72,359,359,500
72,78,78,75,74,377,377,500
73,72,78,70,77,370,370,500
75,76,71,74,76,372,372,500
77,77,70,72,72,368,368,500
70,71,77,77,75,370,370,500
77,72,70,74,74,367,367,500
78,73,78,73,73,375,375,500
70,73,73,75,77,368,368,500
77,73,74,76,78,378,378,500
70,77,78,77,71,373,373,500
74,74,78,74,72,372,372,500
71,71,78,73,77,370,370,500
70,71,70,76,70,357,357,500
78,76,70,77,71,372,372,500
73,78,71,72,72,366,366,500
73,76,73,76,73,371,371,500
76,78,77,71,72,374,374,500
78,72,74,76,77,377,377,500
71,72,73,74,74,364,364,500
74,75,75,70,72,366,366,500
77,75,75,78,71,376,376,500
78,75,72,73,73,371,371,500
77,77,73,77,72,376,376,500
78,78,71,74,71,372,372,500
73,75,72,74,72,366,366,500
74,70,78,75,71,368,368,500
72,76,70,73,73,364,364,500
75,78,72,75,71,371,371,500
74,71,78,74,73,370,370,500
71,72,74,73,77,367,367,500
73,75,77,78,76,379,379,500
70,70,78,70,76,364,364,500
76,76,74,72,77,375,375,500
73,76,72,72,71,364,364,500
75,77,73,70,78,373,373,500
73,75,70,72,75,365,365,500
77,75,70,77,74,373,373,500
71,76,78,71,75,371,371,500
73,74,78,74,77,376,376,500
74,77,74,75,72,372,372,500
73,70,78,75,74,370,370,500
74,75,71,75,72,367,367,500
72,76,71,71,76,366,366,500
70,74,71,72,73,360,360,500
74,75,77,78,76,380,380,500
75,75,71,75,73,369,369,500
78,71,71,76,78,374,374,500
75,72,73,77,70,367,367,500
70,75,77,73,70,365,365,500
71,74,72,78,75,370,370,500
76,71,76,78,73,374,374,500
73,78,75,72,75,373,373,500
73,74,77,71,73,368,368,500
75,73,78,75,74,375,375,500
76,78,71,73,74,372,372,500
73,76,73,77,78,377,377,500
73,78,72,72,72,367,367,500
76,74,78,72,73,373,373,500
75,76,76,74,71,372,372,500
72,71,74,77,70,364,364,500
72,71,73,73,76,365,365,500
76,78,71,72,73,370,370,500
75,78,70,75,73,371,371,500
71,73,71,70,77,362,362,500
76,74,77,71,75,373,373,500
71,71,71,76,75,364,364,500
78,73,73,75,77,376,376,500
70,77,74,70,76,367,367,500
75,77,72,77,73,374,374,500
75,73,77,77,70,372,372,500
71,75,71,71,75,363,363,500
70,72,74,72,70,358,358,500
74,78,71,70,74,367,367,500
70,75,71,76,74,366,366,500
70,73,74,71,78,366,366,500
75,76,71,76,71,369,369,500
70,73,72,74,73,362,362,500
74,78,77,78,70,377,377,500
77,73,70,73,73,366,366,500
76,71,76,74,73,370,370,500
78,77,73,76,70,374,374,500
76,72,70,76,73,367,367,500
76,78,72,76,75,377,377,500
74,74,78,74,75,375,375,500
77,71,74,73,70,365,365,500
71,70,74,78,72,365,365,500
71,71,78,70,73,363,363,500
77,74,70,76,71,368,368,500
77,70,71,72,70,360,360,500
71,71,73,71,75,361,361,500
76,70,72,72,71,361,361,500
75,73,75,75,77,375,375,500
70,76,72,75,71,364,364,500
74,75,71,73,75,368,368,500
76,76,72,76,78,378,378,500
73,72,72,70,72,359,359,500
70,76,73,77,76,372,372,500
74,73,76,76,78,377,377,500
71,78,76,73,75,373,373,500
77,77,76,76,71,377,377,500
77,72,73,74,72,368,368,500
71,78,73,75,77,374,374,500
75,77,72,70,76,370,370,500
77,73,73,77,74,374,374,500
76,78,72,72,71,369,369,500
71,77,78,71,78,375,375,500
78,74,75,73,76,376,376,500
74,71,71,72,78,366,366,500
76,76,76,72,70,370,370,500
72,75,77,78,74,376,376,500
70,70,71,70,78,359,359,500
70,75,76,77,72,370,370,500
72,77,78,74,72,373,373,500
73,72,76,77,75,373,373,500
75,77,72,73,73,370,370,500
73,72,71,73,72,361,361,500
71,76,70,72,74,363,363,500
70,74,70,78,77,369,369,500
78,72,78,73,78,379,379,500
70,75,70,75,75,365,365,500
76,76,70,75,72,369,369,500
74,70,76,77,77,374,374,500
78,72,75,76,70,371,371,500
73,70,75,75,75,368,368,500
70,78,72,74,74,368,368,500
76,72,70,70,70,358,358,500
77,74,73,77,74,375,375,500
71,70,71,71,72,355,355,500
71,74,76,76,72,369,369,500
76,77,70,76,72,371,371,500
71,70,76,76,72,365,365,500
73,72,70,74,74,363,363,500
78,72,71,75,75,371,371,500
75,78,70,70,71,364,364,500
78,75,75,77,77,382,382,500
71,71,75,75,78,370,370,500
76,73,74,72,75,370,370,500
76,70,74,73,73,366,366,500
78,73,75,76,76,378,378,500
72,75,76,77,70,370,370,500
71,73,75,78,75,372,372,500
76,77,70,76,77,376,376,500
70,77,73,78,74,372,372,500
73,73,70,73,75,364,364,500
72,71,78,78,77,376,376,500
77,77,70,76,72,372,372,500
78,75,71,73,77,374,374,500
75,74,71,71,75,366,366,500
75,73,75,76,78,377,377,500
73,72,70,77,73,365,365,500
72,73,77,70,75,367,367,500
71,77,75,76,70,369,369,500
75,76,77,70,77,375,375,500
71,74,73,76,75,369,369,500
72,76,71,71,70,360,360,500
71,73,77,73,74,368,368,500
74,73,78,72,76,373,373,500
77,70,75,73,78,373,373,500
72,70,70,72,71,355,355,500
78,78,78,76,76,386,386,500
77,73,70,73,72,365,365,500
77,76,72,75,74,374,374,500
73,71,70,71,74,359,359,500
74,71,78,72,75,370,370,500
77,70,73,70,76,366,366,500
74,72,78,74,72,370,370,500
73,75,71,75,77,371,371,500
77,70,75,72,70,364,364,500
70,75,77,76,75,373,373,500
75,77,70,75,74,371,371,500
75,73,78,71,70,367,367,500
71,76,74,76,74,371,371,500
78,71,78,71,71,369,369,500
72,74,72,71,75,364,364,500
73,70,78,74,75,370,370,500
74,74,73,77,78,376,376,500
78,75,73,72,75,373,373,500
73,77,76,72,76,374,374,500
74,74,78,70,72,368,368,500
75,78,77,70,76,376,376,500
77,74,72,78,71,372,372,500
73,76,70,71,78,368,368,500
71,76,74,77,73,371,371,500
71,78,76,71,72,368,368,500
75,73,72,76,77,373,373,500
72,76,71,76,73,368,368,500
73,73,73,71,74,364,364,500
78,75,75,73,77,378,378,500
77,72,72,72,71,364,364,500
70,75,73,75,71,364,364,500
70,75,77,76,71,369,369,500
72,73,76,73,70,364,364,500
77,76,78,74,75,380,380,500
78,72,75,70,73,368,368,500
74,75,76,72,74,371,371,500
72,70,72,71,72,357,357,500
78,71,71,78,73,371,371,500
75,75,76,76,76,378,378,500
76,71,71,75,78,371,371,500
74,72,72,76,71,365,365,500
73,71,72,71,76,363,363,500
77,72,75,71,76,371,371,500
72,75,74,77,75,373,373,500
71,74,72,76,71,364,364,500
72,78,76,77,71,374,374,500
77,74,78,74,74,377,377,500
76,72,78,72,76,374,374,500
70,77,74,72,73,366,366,500
77,74,70,75,78,374,374,500
70,76,76,78,77,377,377,500
74,72,75,77,78,376,376,500
77,71,76,73,72,369,369,500
74,75,76,75,74,374,374,500
74,74,72,71,72,363,363,500
75,71,73,74,77,370,370,500
77,71,71,78,77,374,374,500
71,72,70,75,77,365,365,500
78,71,72,76,72,369,369,500
76,70,76,76,71,369,369,500
74,77,71,78,72,372,372,500
73,75,72,73,74,367,367,500
71,70,72,77,73,363,363,500
75,71,71,72,73,362,362,500
70,77,70,71,73,361,361,500
75,78,72,71,73,369,369,500
75,77,70,70,74,366,366,500
70,73,73,72,75,363,363,500
75,75,74,76,73,373,373,500
76,71,70,78,70,365,365,500
76,74,78,76,77,381,381,500
77,74,74,73,77,375,375,500
70,77,72,70,76,365,365,500
77,70,76,71,72,366,366,500
78,73,74,75,76,376,376,500
71,77,76,74,77,375,375,500
75,75,72,77,74,373,373,500
73,73,76,75,72,369,369,500
74,74,71,78,78,375,375,500
78,72,74,73,75,372,372,500
71,72,78,78,78,377,377,500
70,78,73,74,71,366,366,500
72,71,70,70,70,353,353,500
71,74,76,72,73,366,366,500
71,72,77,72,71,363,363,500
75,73,78,72,75,373,373,500
72,78,78,78,74,380,380,500
72,73,72,70,75,362,362,500
74,72,73,71,70,360,360,500
75,75,74,73,71,368,368,500
76,73,70,72,71,362,362,500
71,77,75,76,71,370,370,500
78,75,78,72,70,373,373,500
77,74,76,76,74,377,377,500
72,72,77,74,74,369,369,500
75,73,74,70,73,365,365,500
70,73,77,73,74,367,367,500
76,72,73,74,77,372,372,500
78,75,72,73,71,369,369,500
74,73,77,75,75,374,374,500
71,78,78,76,77,380,380,500
77,71,76,75,72,371,371,500
77,71,78,70,70,366,366,500
78,74,71,70,75,368,368,500
78,70,72,70,72,362,362,500
76,71,75,75,74,371,371,500
77,72,70,77,73,369,369,500
78,76,72,77,76,379,379,500
77,72,76,70,71,366,366,500
75,75,71,74,78,373,373,500
70,74,77,72,78,371,371,500
74,75,74,72,72,367,367,500
77,75,77,72,74,375,375,500
74,78,73,71,77,373,373,500
72,78,78,73,78,379,379,500
75,74,70,71,77,367,367,500
76,77,76,71,74,374,374,500
74,70,78,75,78,375,375,500
70,77,71,75,75,368,368,500
71,70,77,71,73,362,362,500
71,70,72,75,78,366,366,500
70,74,71,75,74,364,364,500
76,76,77,73,76,378,378,500
70,76,78,73,74,371,371,500
70,75,75,73,78,371,371,500
76,78,77,70,74,375,375,500
76,75,73,76,76,376,376,500
75,75,72,77,74,373,373,500
72,75,70,71,73,361,361,500
76,72,75,73,70,366,366,500
77,78,76,78,78,387,387,500
75,76,75,70,77,373,373,500
70,76,77,74,77,374,374,500
75,75,72,77,78,377,377,500
75,77,78,72,71,373,373,500
74,76,72,70,76,368,368,500
76,76,74,75,73,374,374,500
76,75,71,77,72,371,371,500
71,77,71,76,78,373,373,500
73,72,75,73,76,369,369,500
71,74,70,74,73,362,362,500
71,78,71,71,73,364,364,500
74,71,74,75,78,372,372,500
77,78,74,71,74,374,374,500
75,74,72,77,71,369,369,500
71,72,71,78,78,370,370,500
74,70,74,75,74,367,367,500
70,73,72,78,76,369,369,500
71,73,71,76,74,365,365,500
75,72,72,70,76,365,365,500
76,76,73,73,77,375,375,500
75,76,74,77,78,380,380,500
73,72,75,75,76,371,371,500
73,71,72,76,72,364,364,500
71,71,73,76,77,368,368,500
77,71,76,74,77,375,375,500
71,74,77,71,75,368,368,500
74,76,75,70,77,372,372,500
74,77,70,78,72,371,371,500
75,75,72,78,72,372,372,500
70,75,70,72,73,360,360,500
72,78,75,75,78,378,378,500
76,77,75,76,71,375,375,500
76,72,71,76,75,370,370,500
71,75,72,75,72,365,365,500
70,71,78,77,74,370,370,500
74,70,78,70,75,367,367,500
75,77,77,74,78,381,381,500
75,76,71,75,71,368,368,500
72,70,71,71,72,356,356,500
74,72,74,76,72,368,368,500
78,78,70,72,70,368,368,500
73,75,71,71,78,368,368,500
74,70,72,73,77,366,366,500
70,77,70,75,75,367,367,500
75,76,76,72,71,370,370,500
76,76,72,78,75,377,377,500
73,73,74,70,74,364,364,500
70,72,77,76,74,369,369,500
75,70,74,76,74,369,369,500
78,77,72,72,71,370,370,500
72,75,75,70,78,370,370,500
73,75,72,77,73,370,370,500
77,77,73,76,71,374,374,500
73,71,73,72,75,364,364,500
72,71,77,70,70,360,360,500
77,77,77,73,75,379,379,500
71,71,71,70,73,356,356,500
75,77,70,78,73,373,373,500
73,78,75,74,72,372,372,500
73,74,77,78,74,376,376,500
77,71,76,77,71,372,372,500
77,75,77,73,71,373,373,500
78,75,78,74,77,382,382,500
70,73,78,78,70,369,369,500
78,78,78,71,70,375,375,500
77,76,78,74,76,381,381,500
72,72,72,78,71,365,365,500
71,74,76,75,76,372,372,500
78,75,78,77,76,384,384,500
74,76,76,73,72,371,371,500
70,72,71,78,70,361,361,500
78,75,77,71,72,373,373,500
75,72,75,76,71,369,369,500
74,71,74,78,72,369,369,500
71,74,73,76,77,371,371,500
76,72,77,73,70,368,368,500
77,70,74,76,71,368,368,500
75,76,75,74,73,373,373,500
77,71,77,74,71,370,370,500
74,70,76,73,77,370,370,500
70,77,75,70,70,362,362,500
74,74,78,71,74,371,371,500
71,73,76,75,75,370,370,500
70,76,76,71,72,365,365,500
74,76,71,74,74,369,369,500
75,70,72,75,76,368,368,500
77,74,74,71,77,373,373,500
75,74,73,72,75,369,369,500
70,73,72,70,74,359,359,500
70,78,75,72,70,365,365,500
72,71,70,73,72,358,358,500
70,77,75,75,77,374,374,500
72,72,73,73,78,368,368,500
75,71,76,72,76,370,370,500
78,73,70,72,70,363,363,500
72,70,78,77,78,375,375,500
73,77,72,77,78,377,377,500
70,72,75,74,74,365,365,500
71,77,78,74,71,371,371,500
72,72,70,70,78,362,362,500
75,75,75,70,75,370,370,500
78,70,73,76,74,371,371,500
76,77,72,72,71,368,368,500
77,75,72,76,76,376,376,500
71,76,74,72,70,363,363,500
73,76,72,78,77,376,376,500
75,72,71,74,74,366,366,500
73,78,76,78,73,378,378,500
73,78,75,74,74,374,374,500
78,74,78,77,76,383,383,500
77,70,71,74,74,366,366,500
70,74,73,70,77,364,364,500
70,78,78,76,71,373,373,500
77,78,78,77,76,386,386,500
76,77,73,75,76,377,377,500
70,76,72,71,75,364,364,500
76,77,76,70,73,372,372,500
73,71,76,70,73,363,363,500
77,74,78,77,71,377,377,500
78,71,73,72,72,366,366,500
77,73,73,77,74,374,374,500
72,75,78,73,76,374,374,500
70,71,77,77,74,369,369,500
71,73,70,73,73,360,360,500
73,76,75,73,71,368,368,500
76,77,70,71,76,370,370,500
77,72,73,70,77,369,369,500
76,74,70,76,78,374,374,500
72,76,70,73,73,364,364,500
71,70,71,72,74,358,358,500
74,76,75,71,72,368,368,500
78,78,72,76,73,377,377,500
77,72,77,76,70,372,372,500
76,77,71,74,74,372,372,500
78,77,76,71,73,375,375,500
74,70,75,75,70,364,364,500
77,72,76,74,71,370,370,500
77,77,71,77,78,380,380,500
76,75,76,76,71,374,374,500
72,77,71,73,73,366,366,500
74,77,75,72,73,371,371,500
72,73,73,70,70,358,358,500
74,76,71,74,75,370,370,500
77,71,76,74,71,369,369,500
73,72,76,76,75,372,372,500
74,72,75,75,73,369,369,500
74,74,75,71,70,364,364,500
76,75,75,76,76,378,378,500
71,72,77,75,72,367,367,500
70,70,76,76,75,367,367,500
71,77,72,73,71,364,364,500
76,75,78,72,71,372,372,500
77,74,72,71,74,368,368,500
74,71,70,75,75,365,365,500
74,76,74,75,75,374,374,500
78,78,75,72,76,379,379,500
78,73,73,78,70,372,372,500
78,75,73,77,73,376,376,500
77,73,75,77,77,379,379,500
74,78,70,76,74,372,372,500
75,72,75,74,75,371,371,500
72,70,77,71,71,361,361,500
70,72,77,71,78,368,368,500
70,70,75,74,74,363,363,500
74,78,77,72,74,375,375,500
71,70,77,75,74,367,367,500
78,77,73,73,73,374,374,500
72,70,73,71,78,364,364,500
77,78,76,75,70,376,376,500
73,70,72,72,78,365,365,500
76,71,75,76,72,370,370,500
76,75,77,70,78,376,376,500
76,71,73,72,76,368,368,500
74,71,72,77,72,366,366,500
78,74,73,76,74,375,375,500
75,75,72,76,71,369,369,500
78,72,75,77,78,380,380,500
74,73,71,73,76,367,367,500
72,75,70,75,75,367,367,500
70,72,75,74,74,365,365,500
71,73,76,70,76,366,366,500
78,76,73,77,75,379,379,500
78,72,72,71,78,371,371,500
73,70,78,73,77,371,371,500
73,78,77,77,78,383,383,500
73,73,78,75,70,369,369,500
78,77,72,75,75,377,377,500
75,70,78,77,70,370,370,500
72,72,75,73,73,365,365,500
76,78,75,76,76,381,381,500
74,73,73,74,70,364,364,500
74,75,73,77,78,377,377,500
72,72,78,70,75,367,367,500
77,72,76,75,72,372,372,500
75,77,74,73,74,373,373,500
76,73,75,76,72,372,372,500
78,75,70,74,76,373,373,500
71,77,71,77,78,374,374,500
72,70,73,78,71,364,364,500
75,77,70,74,71,367,367,500
77,78,73,77,75,380,380,500
76,77,78,71,78,380,380,500
78,72,78,71,70,369,369,500
70,73,76,70,73,362,362,500
71,78,78,71,73,371,371,500
75,72,75,72,78,372,372,500
75,70,72,70,70,357,357,500
76,73,76,70,78,373,373,500
70,75,77,78,76,376,376,500
77,77,76,74,72,376,376,500
75,78,71,74,73,371,371,500
76,71,75,73,71,366,366,500
71,74,70,71,73,359,359,500
73,72,78,72,77,372,372,500
70,72,71,76,76,365,365,500
77,70,72,71,73,363,363,500
75,74,75,73,76,373,373,500
77,77,78,73,76,381,381,500
70,75,70,73,71,359,359,500
73,75,74,72,72,366,366,500
73,72,73,71,72,361,361,500
77,77,78,75,73,380,380,500
73,73,78,70,74,368,368,500
77,71,74,74,72,368,368,500
78,70,77,75,76,376,376,500
77,76,72,76,76,377,377,500
75,75,73,72,75,370,370,500
75,72,76,75,71,369,369,500
77,77,74,72,74,374,374,500
76,78,76,72,71,373,373,500
76,74,76,74,71,371,371,500
77,73,71,72,78,371,371,500
73,75,73,71,73,365,365,500
77,74,72,76,78,377,377,500
75,77,77,73,73,375,375,500
70,78,72,77,72,369,369,500
72,75,75,77,73,372,372,500
76,75,74,70,76,371,371,500
77,78,76,74,77,382,382,500
78,70,70,76,73,367,367,500
76,78,74,70,70,368,368,500
75,77,75,72,72,371,371,500
76,75,78,70,74,373,373,500
72,76,72,78,71,369,369,500
75,70,76,70,78,369,369,500
75,72,75,73,78,373,373,500
78,76,72,76,71,373,373,500
77,76,73,76,75,377,377,500
71,75,75,74,77,372,372,500
70,74,72,76,76,368,368,500
74,76,70,74,71,365,365,500
71,72,70,78,70,361,361,500
74,71,76,71,76,368,368,500
76,71,71,77,73,368,368,500
77,78,70,75,70,370,370,500
77,70,73,76,71,367,367,500
77,76,75,78,77,383,383,500
72,78,75,72,74,371,371,500
74,75,73,72,72,366,366,500
75,71,75,75,72,368,368,500
72,74,72,71,70,359,359,500
78,75,74,74,71,372,372,500
76,74,72,72,70,364,364,500
70,72,73,74,73,362,362,500
75,73,71,73,72,364,364,500
70,73,72,72,72,359,359,500
78,78,78,72,77,383,383,500
78,72,76,78,70,374,374,500
70,76,72,77,71,366,366,500
71,73,70,78,70,362,362,500
71,74,74,70,73,362,362,500
71,77,75,75,77,375,375,500
74,76,73,73,77,373,373,500
78,78,75,77,73,381,381,500
70,71,72,73,73,359,359,500
78,78,78,74,74,382,382,500
76,71,77,77,78,379,379,500
70,71,74,78,71,364,364,500
74,71,78,71,75,369,369,500
73,71,77,78,70,369,369,500
74,70,74,77,71,366,366,500
73,78,73,74,76,374,374,500
77,71,78,74,70,370,370,500
74,78,74,78,71,375,375,500
71,73,76,77,76,373,373,500
78,76,75,71,75,375,375,500
77,74,77,74,71,373,373,500
77,73,78,71,73,372,372,500
74,73,73,77,71,368,368,500
75,75,71,73,71,365,365,500
72,74,73,70,76,365,365,500
72,70,71,75,71,359,359,500
74,77,73,77,77,378,378,500
74,78,77,74,70,373,373,500
74,77,72,72,71,366,366,500
75,74,74,71,76,370,370,500
72,73,70,72,74,361,361,500
78,71,77,78,71,375,375,500
75,78,72,78,74,377,377,500
75,77,70,70,74,366,366,500
71,75,73,78,76,373,373,500
74,74,70,78,75,371,371,500
75,77,70,76,76,374,374,500
78,78,78,77,73,384,384,500
78,72,70,70,75,365,365,500
77,72,72,70,77,368,368,500
75,76,73,75,72,371,371,500
70,74,74,70,77,365,365,500
78,73,73,76,75,375,375,500
72,72,70,72,77,363,363,500
71,73,73,72,76,365,365,500
73,76,77,75,78,379,379,500
78,76,73,71,75,373,373,500
71,78,72,76,71,368,368,500
73,74,75,74,71,367,367,500
73,75,76,78,71,373,373,500
74,78,75,72,78,377,377,500
73,70,72,70,72,357,357,500
72,77,77,76,75,377,377,500
77,72,73,76,74,372,372,500
76,73,72,78,71,370,370,500
77,77,72,70,74,370,370,500
72,78,76,77,71,374,374,500
73,71,74,72,77,367,367,500
76,73,71,78,77,375,375,500
78,77,70,76,70,371,371,500
75,75,74,76,76,376,376,500
77,71,74,70,70,362,362,500
75,78,71,76,77,377,377,500
76,72,71,70,72,361,361,500
71,72,77,73,72,365,365,500
74,76,71,75,74,370,370,500
73,70,77,74,73,367,367,500
71,76,75,78,70,370,370,500
70,77,70,73,74,364,364,500
78,70,74,71,77,370,370,500
71,71,77,75,71,365,365,500
71,73,78,70,78,370,370,500
76,78,75,77,73,379,379,500
77,74,72,76,71,370,370,500
76,70,72,77,76,371,371,500
74,73,71,76,74,368,368,500
77,72,74,73,70,366,366,500
73,72,71,71,76,363,363,500
76,75,76,72,78,377,377,500
75,73,76,74,76,374,374,500
72,76,71,72,77,368,368,500
74,78,71,75,70,368,368,500
74,73,74,74,74,369,369,500
73,73,71,73,71,361,361,500
77,75,73,70,77,372,372,500
70,70,76,78,78,372,372,500
70,70,73,70,77,360,360,500
74,71,73,75,72,365,365,500
75,76,72,72,76,371,371,500
76,75,72,75,78,376,376,500
78,74,76,71,70,369,369,500
72,73,70,74,71,360,360,500
76,73,75,75,75,374,374,500
75,77,75,77,71,375,375,500
76,77,78,77,78,386,386,500
74,77,72,76,78,377,377,500
71,71,73,76,70,361,361,500
76,70,71,78,77,372,372,500
73,70,72,77,71,363,363,500
75,72,77,76,76,376,376,500
72,75,74,70,75,366,366,500
71,72,71,75,77,366,366,500
74,72,78,71,72,367,367,500
72,74,70,74,75,365,365,500
75,70,72,75,78,370,370,500
70,72,77,78,76,373,373,500
70,73,70,72,76,361,361,500
76,71,77,71,71,366,366,500
78,73,74,75,72,372,372,500
74,74,72,77,70,367,367,500
78,70,78,74,70,370,370,500
77,74,78,71,72,372,372,500
72,74,71,76,73,366,366,500
76,76,73,71,78,374,374,500
71,78,75,76,78,378,378,500
70,78,78,76,76,378,378,500
75,72,76,71,77,371,371,500
72,74,77,76,72,371,371,500
77,76,75,73,74,375,375,500
72,78,75,74,78,377,377,500
74,72,78,71,74,369,369,500
72,76,77,73,70,368,368,500
76,75,78,70,77,376,376,500
74,77,72,74,74,371,371,500
75,76,71,78,70,370,370,500
77,75,75,76,78,381,381,500
74,77,77,70,74,372,372,500
77,74,71,72,75,369,369,500
74,77,71,72,70,364,364,500
72,75,74,71,74,366,366,500
77,72,74,76,73,372,372,500
78,72,72,71,74,367,367,500
73,72,71,74,73,363,363,500
75,70,70,75,77,367,367,500
72,74,72,78,73,369,369,500
77,77,71,71,75,371,371,500
73,73,74,71,75,366,366,500
76,70,78,78,75,377,377,500
73,70,76,70,72,361,361,500
76,75,76,75,74,376,376,500
73,77,78,76,71,375,375,500
70,77,74,78,72,371,371,500
70,70,76,71,77,364,364,500
74,71,75,77,71,368,368,500
78,73,73,78,75,377,377,500
73,76,75,71,72,367,367,500
71,78,78,73,76,376,376,500
78,70,76,71,70,365,365,500
74,72,76,76,75,373,373,500
76,76,76,70,75,373,373,500
71,75,70,71,72,359,359,500
74,76,77,76,73,376,376,500
76,75,71,77,71,370,370,500
70,71,75,76,71,363,363,500
71,78,73,74,70,366,366,500
76,74,76,71,77,374,374,500
72,71,70,76,72,361,361,500
76,73,72,77,78,376,376,500
74,77,71,70,76,368,368,500
70,78,72,74,77,371,371,500
72,71,77,71,75,366,366,500
70,74,71,73,75,363,363,500
71,73,71,70,77,362,362,500
70,73,74,76,70,363,363,500
78,71,77,75,72,373,373,500
75,74,70,75,76,370,370,500
73,74,72,77,73,369,369,500
73,71,74,75,71,364,364,500
70,70,71,72,74,357,357,500
76,78,77,73,73,377,377,500
73,78,73,77,74,375,375,500
72,70,78,70,74,364,364,500
77,70,76,74,75,372,372,500
78,74,70,74,75,371,371,500
70,76,77,72,73,368,368,500
71,70,71,71,72,355,355,500
71,76,72,76,76,371,371,500
72,73,77,76,74,372,372,500
74,76,73,76,77,376,376,500
74,71,70,73,75,363,363,500
78,70,77,74,71,370,370,500
76,78,77,78,74,383,383,500
77,72,76,75,75,375,375,500
77,70,75,78,72,372,372,500
72,74,70,70,71,357,357,500
74,76,73,75,71,369,369,500
75,78,71,70,76,370,370,500
76,78,74,77,71,376,376,500
75,72,75,71,72,365,365,500
73,76,78,76,76,379,379,500
76,76,75,72,73,372,372,500
75,74,74,78,77,378,378,500
72,70,73,75,72,362,362,500
78,78,73,75,71,375,375,500
72,72,77,70,76,367,367,500
70,72,76,77,70,365,365,500
78,76,77,77,72,380,380,500
70,72,71,75,77,365,365,500
73,78,71,71,73,366,366,500
74,77,77,76,71,375,375,500
76,72,75,72,71,366,366,500
71,74,71,74,71,361,361,500
77,70,75,76,76,374,374,500
72,70,75,76,71,364,364,500
76,72,75,75,71,369,369,500
71,75,75,70,76,367,367,500
73,70,76,77,77,373,373,500
76,75,71,71,78,371,371,500
72,78,71,73,72,366,366,500
72,74,75,75,76,372,372,500
78,78,74,77,72,379,379,500
73,75,77,75,75,375,375,500
73,78,73,72,76,372,372,500
72,73,73,72,71,361,361,500
76,74,70,72,78,370,370,500
73,70,77,70,71,361,361,500
77,72,75,75,75,374,374,500
73,73,71,78,75,370,370,500
70,72,71,71,77,361,361,500
75,72,75,71,71,364,364,500
74,73,78,78,78,381,381,500
74,76,74,78,72,374,374,500
73,73,70,73,77,366,366,500
71,75,78,76,78,378,378,500
70,77,71,73,77,368,368,500
71,72,71,77,75,366,366,500
77,78,72,72,77,376,376,500
73,71,74,75,74,367,367,500
70,76,72,70,75,363,363,500
76,77,75,70,75,373,373,500
76,73,78,74,76,377,377,500
70,77,71,70,74,362,362,500
75,71,77,72,78,373,373,500
77,70,78,78,74,377,377,500
70,77,78,78,71,374,374,500
78,70,74,72,72,366,366,500
74,74,75,71,74,368,368,500
77,74,73,77,71,372,372,500
75,75,72,75,74,371,371,500
76,72,73,70,73,364,364,500
75,71,75,73,78,372,372,500
73,72,71,77,71,364,364,500
71,77,78,75,71,372,372,500
78,75,73,76,74,376,376,500
70,77,77,75,72,371,371,500
75,76,77,76,76,380,380,500
76,71,72,71,78,368,368,500
73,70,78,75,75,371,371,500
76,72,73,72,78,371,371,500
71,75,74,78,77,375,375,500
70,72,71,72,73,358,358,500
77,70,72,76,75,370,370,500
73,76,70,71,77,367,367,500
74,74,72,70,75,365,365,500
74,74,74,74,75,371,371,500
77,75,74,77,71,374,374,500
75,78,77,74,71,375,375,500
71,77,74,72,72,366,366,500
74,73,73,77,78,375,375,500
73,71,71,76,78,369,369,500
76,75,75,78,74,378,378,500
72,74,73,74,71,364,364,500
72,76,78,78,77,381,381,500
78,78,78,73,75,382,382,500
75,70,77,70,77,369,369,500
70,70,75,73,73,361,361,500
76,73,70,78,77,374,374,500
71,76,76,78,75,376,376,500
76,75,76,71,74,372,372,500
76,74,74,76,78,378,378,500
70,74,70,77,74,365,365,500
73,74,72,72,76,367,367,500
75,76,74,74,78,377,377,500
73,74,70,78,75,370,370,500
71,75,78,72,72,368,368,500
76,74,74,70,70,364,364,500
70,72,70,73,74,359,359,500
77,73,75,73,72,370,370,500
72,78,76,70,73,369,369,500
77,75,70,75,70,367,367,500
75,72,77,72,77,373,373,500
77,77,77,76,70,377,377,500
73,74,73,70,78,368,368,500
76,76,76,76,71,375,375,500
77,70,73,72,70,362,362,500
72,72,73,74,76,367,367,500
78,71,77,71,77,374,374,500
71,70,75,73,71,360,360,500
77,73,72,70,77,369,369,500
76,74,72,72,71,365,365,500
77,71,76,78,75,377,377,500
75,75,72,77,75,374,374,500
76,74,73,72,76,371,371,500
78,73,75,75,78,379,379,500
76,76,77,71,78,378,378,500
78,77,70,74,73,372,372,500
73,77,70,78,77,375,375,500
71,75,77,74,74,371,371,500
78,72,70,78,73,371,371,500
71,74,75,73,76,369,369,500
74,75,77,71,70,367,367,500
74,73,73,74,78,372,372,500
74,73,72,75,74,368,368,500
74,78,73,78,77,380,380,500
72,76,70,77,78,373,373,500
70,72,78,70,74,364,364,500
78,75,73,73,73,372,372,500
78,73,76,76,76,379,379,500
75,71,74,72,78,370,370,500
78,72,74,70,70,364,364,500
73,73,70,78,73,367,367,500
72,75,73,73,73,366,366,500
71,73,70,72,72,358,358,500
78,75,71,70,70,364,364,500
76,72,71,77,77,373,373,500
73,71,70,76,77,367,367,500
71,75,70,78,75,369,369,500
73,71,71,70,70,355,355,500
73,74,70,72,74,363,363,500
72,75,78,78,77,380,380,500
71,74,75,78,70,368,368,500
73,77,73,77,76,376,376,500
78,76,77,75,72,378,378,500
76,78,74,72,73,373,373,500
74,76,73,78,72,373,373,500
70,78,75,70,77,370,370,500
76,75,77,70,77,375,375,500
77,72,78,70,72,369,369,500
71,78,78,73,75,375,375,500
76,75,74,76,72,373,373,500
76,73,72,76,75,372,372,500
77,72,73,72,77,371,371,500
73,78,78,72,73,374,374,500
71,72,77,70,76,366,366,500
71,72,70,78,77,368,368,500
74,77,76,74,77,378,378,500
78,75,76,78,74,381,381,500
72,78,72,74,71,367,367,500
78,72,74,74,78,376,376,500
75,73,70,73,73,364,364,500
78,71,74,73,77,373,373,500
78,75,76,74,76,379,379,500
72,72,70,77,75,366,366,500
77,75,74,74,73,373,373,500
76,73,72,77,73,371,371,500
76,71,72,76,73,368,368,500
73,75,71,77,70,366,366,500
76,73,76,74,75,374,374,500
73,74,75,75,71,368,368,500
76,76,73,72,70,367,367,500
77,72,73,77,77,376,376,500
77,70,70,72,77,366,366,500
71,76,75,76,73,371,371,500
73,72,71,73,73,362,362,500
70,76,76,72,71,365,365,500
76,76,71,70,73,366,366,500
72,78,72,72,77,371,371,500
76,71,76,75,75,373,373,500
71,75,70,76,71,363,363,500
77,76,74,72,75,374,374,500
70,78,72,74,78,372,372,500
78,72,78,70,72,370,370,500
71,70,78,70,74,363,363,500
77,73,74,74,71,369,369,500
70,70,71,70,73,354,354,500
70,76,72,77,78,373,373,500
70,73,72,73,74,362,362,500
72,70,75,76,78,371,371,500
74,77,74,72,78,375,375,500
72,77,75,71,74,369,369,500
77,77,78,74,75,381,381,500
72,77,75,74,70,368,368,500
72,70,77,72,78,369,369,500
71,78,71,71,74,365,365,500
74,75,72,76,78,375,375,500
78,70,78,74,78,378,378,500
75,73,73,73,71,365,365,500
72,73,72,74,71,362,362,500
74,71,73,71,76,365,365,500
71,70,78,74,75,368,368,500
73,78,74,75,76,376,376,500
75,72,73,75,72,367,367,500
71,72,70,76,77,366,366,500
71,71,72,74,70,358,358,500
76,76,77,76,75,380,380,500
75,75,76,78,75,379,379,500
73,73,74,74,78,372,372,500
73,70,70,78,78,369,369,500
75,78,73,74,71,371,371,500
71,74,73,72,70,360,360,500
75,74,76,76,71,372,372,500
71,75,78,71,72,367,367,500
75,78,73,78,70,374,374,500
72,70,72,75,77,366,366,500
70,74,74,78,75,371,371,500
70,77,73,78,76,374,374,500
71,76,76,75,72,370,370,500
78,72,77,75,77,379,379,500
73,74,77,76,72,372,372,500
70,73,74,77,71,365,365,500
74,71,75,72,77,369,369,500
70,74,73,75,75,367,367,500
70,74,77,74,72,367,367,500
72,76,76,75,71,370,370,500
77,78,73,78,70,376,376,500
74,78,71,73,76,372,372,500
73,72,75,73,70,363,363,500
78,71,77,74,76,376,376,500
73,70,71,78,71,363,363,500
72,78,75,72,74,371,371,500
77,70,72,73,70,362,362,500
74,74,78,71,74,371,371,500
73,73,70,78,76,370,370,500
73,73,75,70,70,361,361,500
72,75,77,74,76,374,374,500
75,73,73,72,74,367,367,500
73,73,76,76,75,373,373,500
73,73,75,73,78,372,372,500
70,77,73,74,76,370,370,500
74,72,73,77,72,368,368,500
71,74,74,76,78,373,373,500
74,77,73,70,71,365,365,500
76,77,72,77,73,375,375,500
71,70,71,78,78,368,368,500
70,71,72,74,70,357,357,500
76,75,76,78,70,375,375,500
71,73,77,73,76,370,370,500
78,77,71,70,73,369,369,500
74,77,75,72,73,371,371,500
76,72,73,74,72,367,367,500
78,78,74,75,75,380,380,500
75,78,78,78,75,384,384,500
73,78,73,78,72,374,374,500
70,78,75,74,77,374,374,500
74,72,74,77,71,368,368,500
77,72,71,71,78,369,369,500
78,70,72,76,74,370,370,500
77,72,77,75,71,372,372,500
76,78,70,70,74,368,368,500
70,75,76,75,74,370,370,500
77,74,71,72,72,366,366,500
76,77,73,75,75,376,376,500
77,74,75,75,72,373,373,500
70,71,70,73,75,359,359,500
73,73,77,71,73,367,367,500
73,76,78,71,73,371,371,500
71,78,70,77,77,373,373,500
75,72,73,78,75,373,373,500
71,71,76,70,72,360,360,500
72,74,72,70,74,362,362,500
73,78,75,74,70,370,370,500
78,71,74,77,70,370,370,500
76,76,74,77,71,374,374,500
73,76,70,76,71,366,366,500
74,76,72,75,76,373,373,500
71,73,72,71,74,361,361,500
70,74,72,72,75,363,363,500
73,70,75,75,74,367,367,500
75,74,74,76,72,371,371,500
76,76,78,77,72,379,379,500
73,72,73,75,76,369,369,500
77,74,77,75,78,381,381,500
73,70,72,75,71,361,361,500
72,73,70,73,75,363,363,500
70,78,78,77,77,380,380,500
74,75,70,77,73,369,369,500
78,72,77,73,75,375,375,500
73,70,76,71,71,361,361,500
75,70,72,75,78,370,370,500
75,76,77,77,72,377,377,500
70,77,78,73,75,373,373,500
73,72,73,71,73,362,362,500
71,76,76,76,74,373,373,500
72,70,77,73,75,367,367,500
71,75,72,71,71,360,360,500
77,75,74,76,70,372,372,500
76,70,73,75,78,372,372,500
76,74,71,76,77,374,374,500
75,77,72,71,75,370,370,500
71,75,75,70,70,361,361,500
76,76,70,75,71,368,368,500
73,70,70,72,73,358,358,500
78,73,70,77,71,369,369,500
76,72,76,74,76,374,374,500
72,77,71,74,71,365,365,500
72,74,73,73,76,368,368,500
73,76,70,71,78,368,368,500
70,72,70,72,77,361,361,500
72,71,73,75,74,365,365,500
72,74,71,78,74,369,369,500
76,77,73,75,72,373,373,500
70,77,76,76,71,370,370,500
70,73,73,75,76,367,367,500
71,74,75,75,78,373,373,500
76,74,72,70,77,369,369,500
78,74,72,70,71,365,365,500
71,73,78,73,77,372,372,500
75,71,72,73,72,363,363,500
73,72,77,78,72,372,372,500
77,72,73,76,74,372,372,500
77,72,78,71,74,372,372,500
70,73,71,76,71,361,361,500
77,76,71,78,76,378,378,500
75,73,74,71,73,366,366,500
76,78,77,78,71,380,380,500
70,74,70,75,76,365,365,500
73,70,70,70,78,361,361,500
72,78,75,73,77,375,375,500
70,70,77,77,78,372,372,500
75,78,78,74,75,380,380,500
73,76,70,77,77,373,373,500
78,74,72,74,75,373,373,500
70,76,75,71,75,367,367,500
75,76,74,70,76,371,371,500
72,78,70,74,72,366,366,500
72,73,71,70,76,362,362,500
77,72,73,70,75,367,367,500
77,71,71,72,75,366,366,500
72,75,71,78,70,366,366,500
74,73,75,78,71,371,371,500
71,71,78,75,70,365,365,500
77,72,73,77,75,374,374,500
71,72,73,74,73,363,363,500
73,76,71,78,73,371,371,500
74,75,70,72,74,365,365,500
71,77,73,78,73,372,372,500
74,73,75,78,76,376,376,500
73,77,78,77,70,375,375,500
71,72,76,76,75,370,370,500
71,78,74,77,75,375,375,500
71,78,73,71,71,364,364,500
70,76,72,73,77,368,368,500
71,71,75,74,75,366,366,500
75,76,74,74,72,371,371,500
77,73,72,74,78,374,374,500
76,72,71,73,78,370,370,500
76,75,70,73,70,364,364,500
75,70,70,76,74,365,365,500
71,70,75,76,70,362,362,500
74,75,73,77,73,372,372,500
74,75,75,75,74,373,373,500
70,78,72,77,75,372,372,500
70,75,77,78,70,370,370,500
75,77,74,76,76,378,378,500
75,70,73,74,74,366,366,500
76,78,77,78,74,383,383,500
70,77,71,75,76,369,369,500
75,72,77,78,74,376,376,500
74,70,77,78,76,375,375,500
73,73,75,75,77,373,373,500
78,78,74,70,76,376,376,500
70,71,73,77,78,369,369,500
75,78,77,70,74,374,374,500
72,72,77,73,78,372,372,500
73,76,77,76,74,376,376,500
77,72,70,73,74,366,366,500
72,73,76,73,76,370,370,500
76,76,71,78,71,372,372,500
70,78,76,74,70,368,368,500
72,76,77,71,75,371,371,500
74,74,76,73,78,375,375,500
75,70,71,78,74,368,368,500
76,76,73,77,72,374,374,500
78,75,77,73,71,374,374,500
75,75,75,77,73,375,375,500
78,77,77,73,73,378,378,500
75,75,71,78,78,377,377,500
73,75,78,77,77,380,380,500
72,73,73,77,74,369,369,500
70,75,78,78,71,372,372,500
77,75,76,71,75,374,374,500
73,71,71,74,78,367,367,500
70,76,73,71,70,360,360,500
75,71,70,70,70,356,356,500
71,77,77,74,76,375,375,500
71,76,78,70,74,369,369,500
70,70,76,78,73,367,367,500
76,73,70,73,75,367,367,500
78,74,78,73,73,376,376,500
75,75,71,71,72,364,364,500
78,71,76,78,72,375,375,500
76,76,75,73,73,373,373,500
72,74,76,71,74,367,367,500
72,75,77,70,76,370,370,500
77,76,70,75,75,373,373,500
74,70,78,73,77,372,372,500
76,74,71,70,73,364,364,500
73,73,74,73,73,366,366,500
76,74,73,77,78,378,378,500
70,77,72,73,71,363,363,500
73,77,76,70,78,374,374,500
77,73,74,70,75,369,369,500
76,78,72,76,78,380,380,500
78,77,73,72,70,370,370,500
74,78,70,72,78,372,372,500
72,73,78,70,76,369,369,500
76,75,71,73,78,373,373,500
72,73,77,74,76,372,372,500
78,75,73,76,75,377,377,500
75,78,75,71,73,372,372,500
74,78,73,71,75,371,371,500
77,72,73,71,71,364,364,500
70,72,78,76,75,371,371,500
77,76,76,74,70,373,373,500
78,77,71,74,74,374,374,500
70,72,74,74,71,361,361,500
74,75,73,76,74,372,372,500
76,74,78,71,76,375,375,500
70,73,72,75,75,365,365,500
71,72,71,78,71,363,363,500
71,78,77,74,74,374,374,500
71,77,70,78,71,367,367,500
78,73,76,70,77,374,374,500
70,78,74,74,73,369,369,500
74,76,77,70,74,371,371,500
72,73,78,78,71,372,372,500
70,71,75,74,74,364,364,500
72,72,78,74,75,371,371,500
73,75,78,77,72,375,375,500
73,73,77,76,78,377,377,500
78,73,78,77,71,377,377,500
71,70,77,75,71,364,364,500
71,72,74,75,70,362,362,500
76,78,76,78,76,384,384,500
75,71,76,78,71,371,371,500
78,77,74,73,72,374,374,500
74,78,77,71,75,375,375,500
75,72,71,74,76,368,368,500
77,72,74,76,72,371,371,500
72,75,72,71,72,362,362,500
74,74,76,73,76,373,373,500
73,72,77,75,78,375,375,500
73,72,77,74,74,370,370,500
72,72,78,72,77,371,371,500
78,74,70,71,72,365,365,500
77,77,78,75,76,383,383,500
76,70,71,73,78,368,368,500
78,78,77,71,78,382,382,500
72,70,71,76,76,365,365,500
77,70,74,72,76,369,369,500
76,70,72,75,70,363,363,500
74,73,70,73,70,360,360,500
70,75,77,73,74,369,369,500
76,70,78,75,71,370,370,500
73,74,72,73,70,362,362,500
77,77,73,74,78,379,379,500
73,72,78,73,77,373,373,500
73,76,70,78,76,373,373,500
74,73,73,78,71,369,369,500
73,75,77,77,72,374,374,500
71,76,74,75,73,369,369,500
71,73,70,71,78,363,363,500
71,77,72,77,70,367,367,500
72,77,71,78,71,369,369,500
73,77,75,71,73,369,369,500
78,76,76,75,71,376,376,500
70,70,72,75,74,361,361,500
76,76,76,73,74,375,375,500
71,78,73,74,76,372,372,500
74,72,73,76,76,371,371,500
78,76,73,76,74,377,377,500
71,71,78,78,77,375,375,500
75,77,76,70,74,372,372,500
75,71,72,77,78,373,373,500
70,72,70,75,78,365,365,500
78,74,75,70,74,371,371,500
72,75,73,76,70,366,366,500
72,74,72,72,77,367,367,500
74,75,78,76,72,375,375,500
75,77,77,75,72,376,376,500
77,76,75,74,77,379,379,500
75,77,72,72,71,367,367,500
76,74,76,78,77,381,381,500
76,71,73,71,71,362,362,500
71,76,78,78,71,374,374,500
70,77,77,74,78,376,376,500
77,78,74,73,77,379,379,500
71,77,70,74,73,365,365,500
74,75,75,72,71,367,367,500
72,75,74,75,74,370,370,500
76,72,75,77,72,372,372,500
77,78,72,73,76,376,376,500
77,75,71,76,73,372,372,500
75,70,76,76,74,371,371,500
76,73,72,76,77,374,374,500
73,78,71,72,72,366,366,500
71,71,75,73,74,364,364,500
75,70,74,70,70,359,359,500
78,74,73,72,78,375,375,500
70,71,72,78,70,361,361,500
73,77,70,72,77,369,369,500
73,74,73,74,72,366,366,500
78,73,75,78,77,381,381,500
72,76,74,72,70,364,364,500
71,74,74,70,70,359,359,500
75,74,76,71,73,369,369,500
70,73,73,71,78,365,365,500
76,73,77,71,72,369,369,500
75,72,77,75,74,373,373,500
75,71,72,71,78,367,367,500
72,72,73,75,77,369,369,500
76,70,77,75,72,370,370,500
71,75,73,73,75,367,367,500
78,74,70,75,70,367,367,500
72,73,76,70,73,364,364,500
71,76,77,72,70,366,366,500
74,70,70,77,75,366,366,500
77,73,73,76,70,369,369,500
75,75,70,77,71,368,368,500
74,75,75,76,71,371,371,500
76,76,73,71,74,370,370,500
70,70,74,73,76,363,363,500
74,73,77,70,70,364,364,500
78,75,74,72,72,371,371,500
75,74,78,77,74,378,378,500
74,73,70,78,76,371,371,500
77,75,70,73,78,373,373,500
71,71,70,70,77,359,359,500
76,73,76,74,76,375,375,500
72,76,70,73,76,367,367,500
76,71,71,76,72,366,366,500
72,75,72,73,71,363,363,500
72,73,77,77,71,370,370,500
73,71,72,78,70,364,364,500
78,75,70,75,71,369,369,500
78,74,76,75,72,375,375,500
70,78,70,77,76,371,371,500
74,73,70,75,75,367,367,500
71,74,76,75,72,368,368,500
78,75,75,74,76,378,378,500
70,75,78,72,77,372,372,500
74,75,77,78,74,378,378,500
70,77,70,70,72,359,359,500
73,73,76,73,72,367,367,500
76,74,71,78,71,370,370,500
74,75,77,72,78,376,376,500
77,74,72,73,77,373,373,500
77,72,78,71,76,374,374,500
78,77,73,77,71,376,376,500
71,77,75,71,71,365,365,500
70,77,77,78,74,376,376,500
72,73,73,73,70,361,361,500
71,78,71,73,75,368,368,500
73,70,70,75,70,358,358,500
75,70,70,76,72,363,363,500
76,77,75,77,72,377,377,500
73,76,76,74,78,377,377,500
75,74,72,76,72,369,369,500
77,78,76,72,73,376,376,500
78,78,71,78,76,381,381,500
78,78,76,76,74,382,382,500
73,75,78,78,74,378,378,500
72,75,76,70,75,368,368,500
77,73,71,77,76,374,374,500
73,74,72,70,73,362,362,500
71,76,74,72,72,365,365,500
70,78,76,73,75,372,372,500
78,77,72,78,78,383,383,500
75,77,77,72,77,378,378,500
73,77,73,71,71,365,365,500
78,75,75,76,77,381,381,500
76,74,72,74,71,367,367,500
76,76,70,76,70,368,368,500
73,78,77,78,75,381,381,500
78,72,70,70,73,363,363,500
70,78,74,78,78,378,378,500
71,74,74,76,78,373,373,500
73,73,76,72,73,367,367,500
77,70,74,77,76,374,374,500
76,73,71,72,70,362,362,500
73,74,71,72,73,363,363,500
78,74,76,73,70,371,371,500
73,73,74,78,74,372,372,500
71,70,71,73,76,361,361,500
73,71,72,77,71,364,364,500
71,71,78,76,70,366,366,500
71,76,73,78,78,376,376,500
75,71,74,74,76,370,370,500
77,71,72,75,74,369,369,500
71,70,75,78,74,368,368,500
77,73,77,77,75,379,379,500
70,72,73,77,78,370,370,500
75,74,70,78,77,374,374,500
76,77,75,75,75,378,378,500
70,75,78,76,77,376,376,500
72,78,70,77,72,369,369,500
74,78,77,74,77,380,380,500
78,71,73,74,75,371,371,500
78,77,71,71,76,373,373,500
74,70,74,73,78,369,369,500
70,71,75,78,76,370,370,500
75,76,72,78,73,374,374,500
75,75,70,73,74,367,367,500
70,71,71,76,78,366,366,500
71,74,77,71,78,371,371,500
73,75,77,78,70,373,373,500
71,74,71,76,78,370,370,500
78,73,75,70,72,368,368,500
78,75,73,78,74,378,378,500
75,78,74,78,78,383,383,500
78,78,77,72,70,375,375,500
75,78,75,74,71,373,373,500
78,71,71,76,72,368,368,500
77,70,73,74,78,372,372,500
78,77,75,74,76,380,380,500
72,76,75,73,77,373,373,500
73,75,75,74,76,373,373,500
74,72,75,72,72,365,365,500
71,70,74,76,73,364,364,500
75,78,75,75,76,379,379,500
74,74,74,70,71,363,363,500
76,73,76,77,77,379,379,500
78,76,78,71,76,379,379,500
72,74,75,75,71,367,367,500
75,72,74,74,70,365,365,500
73,78,73,77,74,375,375,500
72,75,74,78,77,376,376,500
72,76,70,70,75,363,363,500
71,75,71,78,77,372,372,500
78,73,78,77,71,377,377,500
75,71,70,72,72,360,360,500
74,75,73,75,77,374,374,500
72,76,72,76,73,369,369,500
75,73,78,75,71,372,372,500
72,74,75,74,77,372,372,500
74,75,76,70,73,368,368,500
70,72,74,78,75,369,369,500
74,70,78,72,72,366,366,500
76,75,76,78,71,376,376,500
72,75,70,71,73,361,361,500
70,72,72,73,74,361,361,500
75,75,78,77,78,383,383,500
71,71,78,72,76,368,368,500
75,76,73,74,76,374,374,500
72,72,76,78,70,368,368,500
76,70,71,72,75,364,364,500
72,74,70,74,76,366,366,500
74,75,78,72,76,375,375,500
76,77,74,70,72,369,369,500
70,74,75,77,71,367,367,500
74,71,76,70,75,366,366,500
77,75,73,78,78,381,381,500
70,72,70,73,70,355,355,500
75,78,76,78,74,381,381,500
72,71,72,70,74,359,359,500
75,76,72,76,74,373,373,500
73,71,71,74,75,364,364,500
72,74,77,73,76,372,372,500
75,77,74,75,74,375,375,500
76,70,76,78,76,376,376,500
77,75,73,74,77,376,376,500
72,75,72,70,71,360,360,500
71,75,70,76,76,368,368,500
74,78,78,70,75,375,375,500
72,74,75,75,70,366,366,500
73,76,75,72,78,374,374,500
70,75,70,76,74,365,365,500
75,76,72,73,73,369,369,500
76,70,74,78,75,373,373,500
77,77,72,78,76,380,380,500
74,73,72,71,74,364,364,500
77,75,77,75,74,378,378,500
71,75,75,71,76,368,368,500
73,75,75,77,72,372,372,500
77,77,71,72,72,369,369,500
73,71,78,77,74,373,373,500
73,76,70,76,78,373,373,500
70,71,75,78,73,367,367,500
72,70,72,70,77,361,361,500
71,70,73,72,75,361,361,500
72,73,77,77,73,372,372,500
75,70,76,75,74,370,370,500
73,70,72,72,73,360,360,500
74,76,72,74,74,370,370,500
77,74,73,74,74,372,372,500
75,72,70,75,74,366,366,500
70,73,77,78,77,375,375,500
74,73,73,73,72,365,365,500
72,74,76,74,78,374,374,500
73,72,78,76,72,371,371,500
70,78,73,73,71,365,365,500
77,76,76,78,73,380,380,500
78,72,71,76,72,369,369,500
71,74,76,71,74,366,366,500
76,78,76,76,71,377,377,500
73,76,72,72,76,369,369,500
73,78,71,77,75,374,374,500
70,77,70,77,71,365,365,500
77,74,78,73,76,378,378,500
72,70,77,74,73,366,366,500
76,77,75,77,75,380,380,500
78,72,71,74,78,373,373,500
77,72,71,78,71,369,369,500
70,70,78,76,71,365,365,500
73,71,73,73,74,364,364,500
78,74,78,75,71,376,376,500
71,70,70,72,75,358,358,500
76,77,73,73,71,370,370,500
70,72,78,72,75,367,367,500
73,71,70,77,72,363,363,500
71,74,73,71,78,367,367,500
78,77,71,74,78,378,378,500
75,75,75,72,74,371,371,500
71,76,74,72,77,370,370,500
76,72,76,73,77,374,374,500
73,72,73,75,74,367,367,500
70,73,74,72,74,363,363,500
73,73,75,75,74,370,370,500
73,70,76,77,78,374,374,500
74,75,72,75,72,368,368,500
74,70,78,73,71,366,366,500
70,74,72,77,72,365,365,500
72,73,76,71,75,367,367,500
73,78,72,75,71,369,369,500
71,76,75,75,74,371,371,500
76,76,77,72,75,376,376,500
74,71,78,75,77,375,375,500
71,78,71,75,75,370,370,500
76,76,78,76,76,382,382,500
71,73,73,75,74,366,366,500
70,71,77,73,77,368,368,500
74,70,72,71,70,357,357,500
78,77,72,76,76,379,379,500
77,70,74,73,73,367,367,500
71,74,75,74,77,371,371,500
75,72,75,73,72,367,367,500
74,72,75,75,73,369,369,500
73,72,72,72,71,360,360,500
72,74,72,77,70,365,365,500
75,77,70,78,73,373,373,500
71,76,71,72,71,361,361,500
76,71,77,78,72,374,374,500
71,77,73,73,77,371,371,500
74,71,77,72,71,365,365,500
72,76,77,72,74,371,371,500
72,71,72,76,75,366,366,500
78,70,74,77,75,374,374,500
78,77,74,73,72,374,374,500
71,74,77,75,78,375,375,500
72,72,72,78,78,372,372,500
70,78,75,75,76,374,374,500
73,77,73,75,72,370,370,500
77,73,77,72,78,377,377,500
76,77,75,76,71,375,375,500
71,72,76,77,71,367,367,500
72,72,73,75,70,362,362,500
70,77,73,74,71,365,365,500
71,72,74,70,71,358,358,500
71,76,75,73,78,373,373,500
71,73,73,77,76,370,370,500
73,70,78,70,70,361,361,500
75,77,75,74,73,374,374,500
74,72,74,76,75,371,371,500
74,77,78,72,71,372,372,500
76,74,73,76,71,370,370,500
71,75,76,78,75,375,375,500
71,74,71,76,76,368,368,500
74,74,76,71,77,372,372,500
77,73,71,72,71,364,364,500
76,76,78,78,73,381,381,500
76,78,77,71,73,375,375,500
76,70,72,77,73,368,368,500
72,70,75,76,70,363,363,500
78,78,72,72,74,374,374,500
77,77,70,76,74,374,374,500
78,78,76,70,72,374,374,500
72,78,72,78,71,371,371,500
78,76,73,70,70,367,367,500
70,78,74,77,71,370,370,500
76,73,78,71,78,376,376,500
75,74,76,73,70,368,368,500
78,70,76,70,75,369,369,500
71,73,78,72,75,369,369,500
73,71,73,78,76,371,371,500
74,78,72,72,74,370,370,500
76,76,70,76,74,372,372,500
70,74,75,70,77,366,366,500
73,71,73,76,77,370,370,500
77,74,72,75,72,370,370,500
73,75,70,72,72,362,362,500
73,72,78,71,71,365,365,500
73,77,76,76,73,375,375,500
72,73,75,73,70,363,363,500
70,76,70,75,76,367,367,500
71,75,77,74,78,375,375,500
71,70,74,70,75,360,360,500
70,75,72,76,72,365,365,500
76,75,76,71,77,375,375,500
76,76,78,71,71,372,372,500
77,71,78,76,73,375,375,500
73,74,74,76,78,375,375,500
72,76,73,75,70,366,366,500
71,71,70,76,75,363,363,500
77,74,70,72,76,369,369,500
78,73,74,72,71,368,368,500
73,76,72,77,74,372,372,500
76,77,70,71,77,371,371,500
77,78,73,74,73,375,375,500
73,73,71,76,76,369,369,500
75,77,70,78,71,371,371,500
76,70,77,74,75,372,372,500
77,74,74,76,74,375,375,500
71,75,78,74,78,376,376,500
70,78,76,70,73,367,367,500
76,72,75,74,70,367,367,500
73,73,70,74,73,363,363,500
76,72,70,78,75,371,371,500
76,75,77,74,77,379,379,500
77,74,72,77,76,376,376,500
73,73,74,74,74,368,368,500
77,71,72,73,70,363,363,500
70,78,78,76,74,376,376,500
70,71,77,74,70,362,362,500
72,77,71,75,77,372,372,500
74,78,74,72,73,371,371,500
74,73,71,70,77,365,365,500
71,76,76,77,71,371,371,500
78,70,72,77,72,369,369,500
71,76,74,73,74,368,368,500
75,72,70,71,74,362,362,500
71,76,77,77,77,378,378,500
70,77,73,78,70,368,368,500
78,75,75,75,75,378,378,500
72,75,78,75,76,376,376,500
70,78,72,78,70,368,368,500
76,78,70,71,78,373,373,500
77,76,75,72,77,377,377,500
73,76,72,76,75,372,372,500
77,77,76,77,72,379,379,500
77,72,72,77,72,370,370,500
75,78,70,72,71,366,366,500
70,70,70,71,74,355,355,500
75,70,72,74,73,364,364,500
78,71,74,76,73,372,372,500
73,75,76,73,77,374,374,500
72,74,76,71,78,371,371,500
73,75,76,71,77,372,372,500
73,74,74,78,74,373,373,500
71,71,77,75,72,366,366,500
72,77,75,78,78,380,380,500
71,73,74,72,74,364,364,500
75,77,70,73,78,373,373,500
73,75,74,77,72,371,371,500
71,72,75,74,73,365,365,500
78,71,72,75,71,367,367,500
76,77,71,77,77,378,378,500
77,77,71,70,71,366,366,500
72,70,78,72,71,363,363,500
73,70,74,73,70,360,360,500
70,78,70,73,75,366,366,500
74,78,70,72,78,372,372,500
74,72,73,72,74,365,365,500
76,74,75,73,70,368,368,500
70,77,70,71,75,363,363,500
78,71,77,75,74,375,375,500
71,70,73,77,73,364,364,500
78,76,77,70,70,371,371,500
73,70,76,75,70,364,364,500
73,73,72,75,70,363,363,500
74,71,73,70,77,365,365,500
74,76,76,75,77,378,378,500
72,76,74,77,70,369,369,500
78,76,72,71,78,375,375,500
76,74,77,72,71,370,370,500
70,73,76,70,72,361,361,500
77,70,74,76,72,369,369,500
78,74,75,75,76,378,378,500
73,75,75,75,75,373,373,500
73,71,77,70,76,367,367,500
70,70,72,74,76,362,362,500
78,77,71,70,74,370,370,500
75,72,70,70,78,365,365,500
74,71,72,70,78,365,365,500
74,73,70,78,70,365,365,500
70,72,78,73,72,365,365,500
71,76,74,71,77,369,369,500
76,76,72,77,73,374,374,500
71,77,74,76,71,369,369,500
73,72,75,73,72,365,365,500
78,74,73,77,74,376,376,500
76,78,76,75,70,375,375,500
72,78,77,71,74,372,372,500
72,77,77,76,71,373,373,500
71,73,72,74,77,367,367,500
74,74,72,74,71,365,365,500
76,75,74,72,72,369,369,500
71,78,76,76,70,371,371,500
77,74,70,74,77,372,372,500
73,70,73,73,75,364,364,500
70,72,70,71,73,356,356,500
74,77,78,70,78,377,377,500
77,76,77,71,71,372,372,500
77,76,72,75,77,377,377,500
71,70,77,75,71,364,364,500
77,75,75,72,70,369,369,500
78,72,74,78,72,374,374,500
72,77,70,74,74,367,367,500
76,72,74,73,71,366,366,500
72,75,74,73,76,370,370,500
72,77,74,74,70,367,367,500
74,75,74,70,77,370,370,500
70,77,74,78,74,373,373,500
71,73,75,77,72,368,368,500
70,73,70,78,71,362,362,500
72,73,74,76,71,366,366,500
75,76,73,71,70,365,365,500
77,71,72,73,73,366,366,500
74,74,71,75,70,364,364,500
72,74,72,72,77,367,367,500
70,71,78,71,72,362,362,500
74,75,75,76,76,376,376,500
73,72,75,75,77,372,372,500
70,74,70,72,78,364,364,500
74,75,75,72,75,371,371,500
72,70,72,76,72,362,362,500
72,76,76,75,75,374,374,500
78,72,73,73,71,367,367,500
72,75,72,73,72,364,364,500
72,70,76,70,70,358,358,500
77,72,73,75,76,373,373,500
73,75,71,74,73,366,366,500
71,71,77,71,74,364,364,500
78,76,75,72,73,374,374,500
77,78,74,70,73,372,372,500
75,78,76,77,70,376,376,500
78,78,74,73,78,381,381,500
70,78,72,76,72,368,368,500
75,70,72,70,71,358,358,500
73,73,74,76,76,372,372,500
77,74,74,74,78,377,377,500
78,74,74,72,73,371,371,500
73,71,72,74,78,368,368,500
71,70,73,74,77,365,365,500
77,70,72,76,75,370,370,500
73,71,75,78,70,367,367,500
76,75,71,75,77,374,374,500
75,71,72,73,70,361,361,500
73,76,73,70,78,370,370,500
75,74,70,77,72,368,368,500
78,71,76,74,73,372,372,500
72,73,73,72,73,363,363,500
71,78,76,73,71,369,369,500
71,73,72,75,73,364,364,500
74,72,75,70,70,361,361,500
71,71,72,73,73,360,360,500
71,72,74,77,70,364,364,500
73,77,74,76,75,375,375,500
77,75,70,77,76,375,375,500
78,71,78,76,72,375,375,500
73,75,71,72,71,362,362,500
71,73,74,73,71,362,362,500
77,74,70,70,76,367,367,500
75,74,78,78,72,377,377,500
74,71,71,71,71,358,358,500
78,78,75,75,75,381,381,500
72,76,71,74,77,370,370,500
70,77,71,75,75,368,368,500
77,78,74,75,71,375,375,500
73,75,78,76,72,374,374,500
77,71,72,71,74,365,365,500
73,77,74,78,76,378,378,500
76,73,76,75,76,376,376,500
77,76,77,72,73,375,375,500
76,71,73,71,71,362,362,500
73,73,77,74,77,374,374,500
72,71,74,71,75,363,363,500
73,73,76,75,78,375,375,500
70,77,70,71,75,363,363,500
78,74,73,70,70,365,365,500
78,78,75,75,76,382,382,500
70,77,76,71,76,370,370,500
77,73,76,70,72,368,368,500
73,71,78,71,72,365,365,500
75,73,78,74,74,374,374,500
77,73,72,74,78,374,374,500
77,75,78,76,71,377,377,500
71,78,75,76,72,372,372,500
70,75,70,78,77,370,370,500
71,75,70,71,70,357,357,500
73,76,75,75,72,371,371,500
72,76,75,74,72,369,369,500
70,72,70,77,71,360,360,500
77,71,70,78,72,368,368,500
76,70,73,74,76,369,369,500
78,75,76,77,70,376,376,500
78,75,71,72,75,371,371,500
75,76,71,77,76,375,375,500
75,70,78,78,71,372,372,500
71,74,77,72,71,365,365,500
75,75,71,75,72,368,368,500
75,73,74,76,72,370,370,500
72,78,77,75,76,378,378,500
74,76,76,73,75,374,374,500
73,74,76,78,70,371,371,500
77,70,75,70,74,366,366,500
77,76,71,77,75,376,376,500
70,78,76,71,71,366,366,500
74,76,78,74,70,372,372,500
70,74,78,75,75,372,372,500
75,70,73,78,75,371,371,500
70,70,70,77,76,363,363,500
70,75,70,72,78,365,365,500
76,77,73,71,70,367,367,500
72,77,74,77,78,378,378,500
72,76,74,70,78,370,370,500
73,73,77,77,75,375,375,500
78,73,73,73,77,374,374,500
76,77,76,74,77,380,380,500
70,72,74,74,75,365,365,500
78,72,72,73,77,372,372,500
72,77,72,76,75,372,372,500
78,70,71,72,72,363,363,500
78,70,77,70,77,372,372,500
76,71,72,73,75,367,367,500
70,73,70,71,74,358,358,500
72,77,71,72,76,368,368,500
71,71,75,71,71,359,359,500
75,78,75,75,76,379,379,500
72,78,78,72,75,375,375,500
70,74,71,76,75,366,366,500
73,77,74,71,74,369,369,500
76,76,70,78,72,372,372,500
71,72,73,78,77,371,371,500
72,75,77,77,78,379,379,500
70,72,78,72,78,370,370,500
72,71,76,77,75,371,371,500
72,72,78,78,71,371,371,500
70,77,72,77,78,374,374,500
74,70,72,77,73,366,366,500
74,75,70,71,73,363,363,500
71,71,70,72,73,357,357,500
74,71,78,76,71,370,370,500
78,76,75,70,75,374,374,500
76,73,78,77,72,376,376,500
73,77,76,71,77,374,374,500
77,72,76,70,75,370,370,500
75,78,75,75,75,378,378,500
74,76,70,76,73,369,369,500
70,73,75,78,76,372,372,500
75,78,78,71,76,378,378,500
73,70,78,78,72,371,371,500
75,73,75,76,76,375,375,500
76,78,70,73,73,370,370,500
71,74,75,76,72,368,368,500
77,72,71,72,73,365,365,500
77,78,72,73,71,371,371,500
77,75,70,78,76,376,376,500
77,73,76,75,71,372,372,500
76,75,78,70,77,376,376,500
76,71,70,77,73,367,367,500
78,71,75,73,75,372,372,500
74,71,71,74,71,361,361,500
77,73,70,72,75,367,367,500
72,73,70,70,70,355,355,500
76,71,77,74,72,370,370,500
71,77,76,76,75,375,375,500
71,73,70,75,74,363,363,500
75,70,70,72,71,358,358,500
78,78,78,70,77,381,381,500
78,72,71,71,78,370,370,500
74,78,70,75,72,369,369,500
74,71,76,74,73,368,368,500
75,77,70,71,70,363,363,500
77,75,73,73,73,371,371,500
74,76,73,71,72,366,366,500
74,70,72,75,71,362,362,500
70,72,76,73,77,368,368,500
74,76,72,78,70,370,370,500
78,72,71,74,76,371,371,500
73,76,75,73,73,370,370,500
76,71,77,73,78,375,375,500
76,71,77,77,70,371,371,500
74,78,78,75,74,379,379,500
77,78,70,72,77,374,374,500
77,72,71,74,73,367,367,500
78,75,78,75,76,382,382,500
78,70,72,72,72,364,364,500
72,74,72,73,70,361,361,500
78,75,77,72,76,378,378,500
71,77,75,70,71,364,364,500
74,74,74,70,77,369,369,500
75,77,73,74,73,372,372,500
74,77,74,77,70,372,372,500
75,70,75,70,74,364,364,500
74,71,72,74,74,365,365,500
72,75,78,72,73,370,370,500
74,76,74,73,70,367,367,500
73,78,77,72,76,376,376,500
70,70,78,74,72,364,364,500
76,74,72,70,76,368,368,500
77,71,70,74,74,366,366,500
70,78,72,75,71,366,366,500
74,75,74,71,74,368,368,500
78,77,75,70,72,372,372,500
71,78,71,70,70,360,360,500
74,76,75,74,73,372,372,500
76,73,71,70,70,360,360,500
74,72,70,74,71,361,361,500
77,74,71,70,76,368,368,500
75,71,74,72,77,369,369,500
77,73,73,78,71,372,372,500
72,78,77,77,78,382,382,500
74,70,75,70,77,366,366,500
77,72,71,73,73,366,366,500
73,74,70,78,74,369,369,500
73,74,74,75,70,366,366,500
76,77,72,70,78,373,373,500
72,78,78,78,76,382,382,500
74,72,73,72,73,364,364,500
71,71,77,77,78,374,374,500
71,77,73,75,71,367,367,500
78,71,77,73,74,373,373,500
74,73,70,78,75,370,370,500
77,75,74,72,74,372,372,500
74,76,77,70,72,369,369,500
73,70,76,71,70,360,360,500
74,75,76,74,73,372,372,500
71,73,75,70,73,362,362,500
77,72,73,70,75,367,367,500
73,73,71,71,70,358,358,500
73,76,77,78,75,379,379,500
70,71,70,73,77,361,361,500
73,72,75,70,71,361,361,500
75,73,76,75,72,371,371,500
70,71,74,76,72,363,363,500
78,71,71,76,75,371,371,500
70,74,72,70,71,357,357,500
75,76,75,77,75,378,378,500
76,74,72,73,78,373,373,500
70,76,73,72,77,368,368,500
72,71,76,72,78,369,369,500
71,75,77,71,75,369,369,500
74,74,76,77,71,372,372,500
74,76,77,78,78,383,383,500
74,78,74,70,72,368,368,500
70,78,77,72,71,368,368,500
71,75,76,76,75,373,373,500
71,74,78,75,71,369,369,500
72,78,78,71,74,373,373,500
77,74,78,73,74,376,376,500
75,70,77,77,75,374,374,500
77,76,73,76,76,378,378,500
77,71,71,71,78,368,368,500
74,70,78,74,74,370,370,500
71,74,77,70,77,369,369,500
72,75,72,78,73,370,370,500
73,75,77,75,75,375,375,500
75,70,73,72,72,362,362,500
74,77,76,75,74,376,376,500
75,70,72,76,77,370,370,500
78,70,78,70,74,370,370,500
75,77,74,74,72,372,372,500
73,74,73,72,71,363,363,500
70,73,73,72,73,361,361,500
78,73,77,75,71,374,374,500
74,70,74,76,72,366,366,500
77,73,75,73,75,373,373,500
72,73,72,73,76,366,366,500
77,72,73,76,77,375,375,500
74,75,77,78,75,379,379,500
70,73,75,77,71,366,366,500
74,78,73,73,72,370,370,500
78,77,74,74,72,375,375,500
72,70,75,73,76,366,366,500
76,73,71,77,72,369,369,500
77,70,70,76,71,364,364,500
74,70,70,74,78,366,366,500
73,75,73,70,72,363,363,500
78,75,71,74,72,370,370,500
78,74,78,76,73,379,379,500
75,74,76,70,78,373,373,500
73,73,71,73,70,360,360,500
77,73,74,75,76,375,375,500
72,75,77,76,73,373,373,500
73,70,76,72,78,369,369,500
73,70,73,73,75,364,364,500
75,78,74,72,71,370,370,500
74,77,74,71,78,374,374,500
73,71,76,72,70,362,362,500
72,71,70,74,74,361,361,500
72,76,75,77,78,378,378,500
76,71,73,75,78,373,373,500
73,75,73,77,74,372,372,500
70,77,74,70,75,366,366,500
76,72,74,78,77,377,377,500
70,76,75,74,76,371,371,500
75,78,78,71,75,377,377,500
77,74,70,72,75,368,368,500
70,70,72,70,71,353,353,500
74,70,77,78,75,374,374,500
76,71,71,75,74,367,367,500
77,76,72,76,77,378,378,500
70,70,74,77,78,369,369,500
77,71,77,77,75,377,377,500
76,76,70,78,73,373,373,500
75,72,75,78,72,372,372,500
71,75,77,76,74,373,373,500
76,71,73,73,74,367,367,500
74,72,74,74,75,369,369,500
78,76,78,77,70,379,379,500
74,76,74,74,70,368,368,500
72,77,76,72,77,374,374,500
72,73,77,77,73,372,372,500
78,74,76,74,71,373,373,500
71,70,78,76,76,371,371,500
72,73,74,74,76,369,369,500
77,77,72,77,74,377,377,500
74,76,77,72,71,370,370,500
70,76,74,70,72,362,362,500
78,71,78,73,74,374,374,500
74,70,74,70,75,363,363,500
70,71,77,73,76,367,367,500
73,72,78,71,77,371,371,500
72,75,78,77,78,380,380,500
70,78,72,72,72,364,364,500
70,70,72,77,78,367,367,500
78,70,71,76,75,370,370,500
78,78,74,72,75,377,377,500
74,74,74,72,71,365,365,500
73,72,70,72,77,364,364,500
74,74,75,72,70,365,365,500
72,70,70,77,74,363,363,500
74,73,72,75,75,369,369,500
74,77,74,75,75,375,375,500
76,75,71,77,70,369,369,500
76,77,77,78,71,379,379,500
71,73,74,74,72,364,364,500
78,78,74,77,72,379,379,500
76,74,78,77,74,379,379,500
78,76,70,77,71,372,372,500
73,72,76,70,73,364,364,500
78,78,72,74,77,379,379,500
73,76,76,76,77,378,378,500
77,70,75,78,74,374,374,500
78,71,78,70,78,375,375,500
70,73,78,70,73,364,364,500
77,75,76,70,76,374,374,500
76,73,75,78,72,374,374,500
76,73,76,77,70,372,372,500
78,75,71,71,73,368,368,500
72,78,71,73,76,370,370,500
72,73,76,78,73,372,372,500
78,73,70,73,75,369,369,500
71,73,72,78,74,368,368,500
78,75,78,75,70,376,376,500
70,70,72,70,70,352,352,500
72,78,75,72,75,372,372,500
77,74,72,74,75,372,372,500
78,75,76,75,77,381,381,500
70,75,71,77,77,370,370,500
74,76,71,76,73,370,370,500
76,76,75,73,75,375,375,500
72,71,72,72,73,360,360,500
74,70,71,77,70,362,362,500
73,70,74,78,76,371,371,500
70,77,75,74,74,370,370,500
74,71,73,71,74,363,363,500
73,76,72,71,76,368,368,500
77,74,71,78,75,375,375,500
73,71,71,74,75,364,364,500
71,76,70,72,73,362,362,500
75,76,70,74,74,369,369,500
76,74,75,74,77,376,376,500
77,70,71,71,75,364,364,500
74,74,77,77,71,373,373,500
75,70,78,70,71,364,364,500
77,76,74,75,75,377,377,500
71,72,75,74,76,368,368,500
70,74,78,78,72,372,372,500
72,71,71,77,77,368,368,500
76,71,78,74,76,375,375,500
75,77,73,76,70,371,371,500
74,75,73,72,70,364,364,500
78,78,72,72,73,373,373,500
78,70,76,70,74,368,368,500
75,76,77,70,76,374,374,500
77,72,71,78,72,370,370,500
78,71,75,77,74,375,375,500
73,70,76,74,78,371,371,500
71,78,77,70,75,371,371,500
71,72,72,73,77,365,365,500
78,72,73,77,72,372,372,500
71,70,73,73,74,361,361,500
76,77,71,70,74,368,368,500
72,71,71,75,73,362,362,500
71,72,78,78,73,372,372,500
75,75,75,74,78,377,377,500
75,70,71,76,71,363,363,500
72,71,72,70,77,362,362,500
76,76,76,74,78,380,380,500
74,71,70,71,73,359,359,500
72,77,78,71,72,370,370,500
73,76,78,74,72,373,373,500
76,73,76,75,73,373,373,500
70,70,76,72,71,359,359,500
74,78,70,76,72,370,370,500
74,74,75,71,75,369,369,500
74,70,77,74,74,369,369,500
76,73,78,73,74,374,374,500
72,75,72,75,77,371,371,500
77,74,72,74,78,375,375,500
72,74,74,78,75,373,373,500
71,76,76,75,77,375,375,500
77,77,75,77,72,378,378,500
75,71,78,72,70,366,366,500
78,75,76,75,78,382,382,500
75,74,70,75,74,368,368,500
77,70,72,73,73,365,365,500
72,74,74,78,70,368,368,500
77,72,77,77,77,380,380,500
78,73,71,75,77,374,374,500
72,71,70,71,74,358,358,500
70,72,72,76,76,366,366,500
70,73,72,74,74,363,363,500
70,70,73,78,72,363,363,500
72,75,75,78,73,373,373,500
74,78,73,75,72,372,372,500
76,76,76,77,72,377,377,500
78,74,71,75,70,368,368,500
70,76,73,70,71,360,360,500
70,77,77,72,72,368,368,500
77,76,71,72,73,369,369,500
75,78,77,78,78,386,386,500
73,77,75,74,70,369,369,500
74,76,74,72,72,368,368,500
78,73,70,77,74,372,372,500
70,75,70,73,77,365,365,500
71,78,72,71,76,368,368,500
77,77,78,73,77,382,382,500
75,75,70,70,70,360,360,500
75,78,73,71,76,373,373,500
76,71,75,73,75,370,370,500
77,72,75,72,77,373,373,500
74,76,78,72,74,374,374,500
71,76,72,73,78,370,370,500
74,71,71,75,70,361,361,500
77,78,78,71,72,376,376,500
76,78,75,71,77,377,377,500
74,76,75,78,74,377,377,500
74,70,74,71,71,360,360,500
75,73,78,71,70,367,367,500
73,76,75,73,77,374,374,500
76,72,73,75,73,369,369,500
72,74,73,77,71,367,367,500
72,72,73,78,73,368,368,500
72,76,72,71,76,367,367,500
72,78,72,75,73,370,370,500
78,73,74,71,73,369,369,500
72,70,76,74,77,369,369,500
73,70,75,72,72,362,362,500
78,76,78,75,78,385,385,500
70,78,70,77,70,365,365,500
78,72,78,77,77,382,382,500
70,74,76,75,74,369,369,500
72,74,70,75,71,362,362,500
77,70,71,73,70,361,361,500
71,73,70,76,78,368,368,500
76,75,72,78,73,374,374,500
73,77,70,72,75,367,367,500
77,72,76,78,72,375,375,500
71,75,76,70,77,369,369,500
78,71,73,77,73,372,372,500
74,77,73,74,70,368,368,500
70,73,72,70,72,357,357,500
73,75,74,74,70,366,366,500
71,77,72,78,77,375,375,500
70,74,73,72,72,361,361,500
75,74,76,74,73,372,372,500
74,70,74,77,70,365,365,500
75,72,70,74,74,365,365,500
74,71,74,72,77,368,368,500
73,78,75,70,74,370,370,500
77,70,78,76,73,374,374,500
76,78,72,75,76,377,377,500
78,70,75,71,73,367,367,500
78,74,70,78,77,377,377,500
77,71,75,76,74,373,373,500
78,74,71,70,77,370,370,500
73,76,73,75,70,367,367,500
70,76,75,73,78,372,372,500
77,72,71,75,70,365,365,500
74,72,76,77,70,369,369,500
70,78,78,70,75,371,371,500
71,74,70,76,72,363,363,500
71,70,74,72,70,357,357,500
73,76,76,75,77,377,377,500
72,74,73,72,76,367,367,500
72,77,74,76,72,371,371,500
75,76,78,70,74,373,373,500
72,78,75,70,75,370,370,500
78,70,78,78,71,375,375,500
77,77,78,77,74,383,383,500
71,73,70,73,78,365,365,500
74,71,76,73,70,364,364,500
74,71,77,78,75,375,375,500
78,71,77,76,72,374,374,500
71,75,77,77,74,374,374,500
75,74,73,75,72,369,369,500
73,75,76,74,74,372,372,500
73,72,74,72,74,365,365,500
70,70,74,78,77,369,369,500
72,77,70,78,72,369,369,500
73,78,72,76,78,377,377,500
74,73,71,72,72,362,362,500
73,70,75,70,71,359,359,500
73,78,72,70,78,371,371,500
78,76,76,72,70,372,372,500
76,76,76,75,72,375,375,500
72,71,73,71,77,364,364,500
70,75,78,73,70,366,366,500
74,72,74,74,73,367,367,500
70,75,77,70,76,368,368,500
73,70,70,75,75,363,363,500
75,72,77,74,76,374,374,500
72,76,75,76,75,374,374,500
71,73,73,73,76,366,366,500
74,72,72,76,70,364,364,500
78,78,73,77,70,376,376,500
77,76,78,71,76,378,378,500
71,73,71,70,75,360,360,500
75,72,73,71,71,362,362,500
72,77,75,77,72,373,373,500
75,77,78,71,74,375,375,500
71,73,77,71,73,365,365,500
76,76,70,77,72,371,371,500
75,75,74,74,70,368,368,500
78,75,73,77,72,375,375,500
78,72,76,76,71,373,373,500
76,77,75,72,72,372,372,500
74,75,71,72,76,368,368,500
73,72,78,73,78,374,374,500
73,78,72,72,73,368,368,500
74,74,73,72,70,363,363,500
74,70,75,74,76,369,369,500
72,75,71,74,78,370,370,500
70,77,78,73,77,375,375,500
73,74,70,74,71,362,362,500
74,73,74,73,74,368,368,500
76,75,74,74,73,372,372,500
70,77,70,76,70,363,363,500
77,71,75,77,71,371,371,500
74,74,73,73,76,370,370,500
71,76,78,73,72,370,370,500
73,75,72,74,72,366,366,500
73,78,77,75,78,381,381,500
75,73,76,77,73,374,374,500
74,78,71,75,75,373,373,500
76,71,76,76,75,374,374,500
76,72,72,78,74,372,372,500
70,72,72,75,76,365,365,500
76,73,70,78,75,372,372,500
73,75,72,78,73,371,371,500
76,73,71,78,70,368,368,500
74,77,77,75,75,378,378,500
72,78,75,72,73,370,370,500
77,71,77,78,72,375,375,500
74,78,73,77,74,376,376,500
73,75,73,71,75,367,367,500
71,70,74,72,74,361,361,500
74,70,76,78,71,369,369,500
75,75,73,75,74,372,372,500
75,71,78,75,78,377,377,500
72,71,72,76,76,367,367,500
78,74,72,77,73,374,374,500
74,77,73,74,72,370,370,500
75,78,75,74,72,374,374,500
77,78,76,78,71,380,380,500
78,74,74,71,70,367,367,500
76,77,70,75,74,372,372,500
76,72,70,74,78,370,370,500
70,74,78,71,72,365,365,500
71,72,70,75,71,359,359,500
71,78,71,78,76,374,374,500
77,78,73,78,77,383,383,500
71,70,77,74,75,367,367,500
77,77,75,76,71,376,376,500
72,76,78,74,78,378,378,500
70,75,78,70,76,369,369,500
74,74,77,76,70,371,371,500
72,77,74,74,78,375,375,500
75,73,72,74,73,367,367,500
70,71,73,75,74,363,363,500
77,75,75,73,76,376,376,500
72,74,72,72,75,365,365,500
77,73,73,78,74,375,375,500
74,76,70,76,73,369,369,500
77,75,77,73,74,376,376,500
78,76,77,77,74,382,382,500
70,76,75,77,78,376,376,500
77,72,73,77,77,376,376,500
74,73,72,78,71,368,368,500
78,75,75,71,76,375,375,500
74,73,73,77,72,369,369,500
74,72,74,74,75,369,369,500
70,74,74,72,76,366,366,500
75,75,71,73,73,367,367,500
72,72,72,71,76,363,363,500
78,74,76,74,76,378,378,500
74,72,75,72,72,365,365,500
73,73,72,75,77,370,370,500
73,73,74,74,78,372,372,500
71,71,78,75,77,372,372,500
77,76,76,77,78,384,384,500
74,72,78,70,71,365,365,500
73,71,75,70,76,365,365,500
71,72,73,77,71,364,364,500
70,74,75,74,71,364,364,500
72,77,73,76,74,372,372,500
75,71,77,73,74,370,370,500
70,75,72,75,76,368,368,500
78,77,74,73,74,376,376,500
73,72,70,74,76,365,365,500
73,74,73,78,72,370,370,500
74,76,77,73,78,378,378,500
71,76,75,70,72,364,364,500
72,72,77,72,77,370,370,500
75,74,76,73,73,371,371,500
73,78,75,71,72,369,369,500
74,78,72,76,75,375,375,500
71,71,77,71,78,368,368,500
77,75,78,71,74,375,375,500
77,71,72,71,75,366,366,500
72,72,76,78,77,375,375,500
78,77,70,73,71,369,369,500
78,74,77,71,73,373,373,500
71,70,77,75,71,364,364,500
73,72,70,77,72,364,364,500
73,74,76,73,75,371,371,500
70,71,71,74,76,362,362,500
72,76,72,71,71,362,362,500
72,75,75,70,70,362,362,500
76,70,77,75,77,375,375,500
76,71,74,72,74,367,367,500
77,72,70,73,72,364,364,500
71,72,72,74,78,367,367,500
78,77,74,70,71,370,370,500
78,73,72,71,72,366,366,500
72,74,76,78,75,375,375,500
77,70,76,73,73,369,369,500
70,74,75,73,78,370,370,500
74,72,77,77,70,370,370,500
70,74,73,77,72,366,366,500
74,74,70,75,77,370,370,500
76,71,72,73,74,366,366,500
74,76,70,74,71,365,365,500
71,73,70,78,73,365,365,500
74,72,77,72,77,372,372,500
72,74,70,71,70,357,357,500
77,76,70,71,70,364,364,500
70,70,77,75,72,364,364,500
75,72,78,74,77,376,376,500
77,74,72,75,78,376,376,500
74,70,73,78,78,373,373,500
78,78,71,76,75,378,378,500
72,76,77,75,73,373,373,500
71,71,76,70,74,362,362,500
75,72,77,72,75,371,371,500
76,75,77,72,76,376,376,500
77,74,70,72,70,363,363,500
72,77,70,77,76,372,372,500
78,72,72,72,71,365,365,500
73,70,78,73,78,372,372,500
74,72,74,74,72,366,366,500
75,70,70,70,77,362,362,500
72,78,76,72,77,375,375,500
72,74,76,78,74,374,374,500
77,75,73,74,72,371,371,500
73,74,72,70,72,361,361,500
71,71,73,74,70,359,359,500
73,74,74,75,75,371,371,500
78,72,71,76,72,369,369,500
71,74,75,73,71,364,364,500
71,77,75,78,78,379,379,500
70,76,71,74,77,368,368,500
78,75,71,78,70,372,372,500
74,72,75,76,76,373,373,500
72,75,74,76,77,374,374,500
74,73,70,72,72,361,361,500
72,73,78,73,72,368,368,500
76,74,75,76,76,377,377,500
72,74,75,73,74,368,368,500
78,70,77,73,75,373,373,500
71,72,76,76,75,370,370,500
75,75,76,70,73,369,369,500
77,74,76,76,75,378,378,500
70,73,72,73,78,366,366,500
77,75,73,75,73,373,373,500
74,77,77,73,70,371,371,500
77,70,78,70,76,371,371,500
72,78,76,76,75,377,377,500
71,78,78,72,71,370,370,500
73,70,78,77,76,374,374,500
74,71,72,71,71,359,359,500
73,71,78,71,74,367,367,500
71,74,70,75,78,368,368,500
77,73,70,73,76,369,369,500
75,72,75,74,71,367,367,500
78,77,76,74,70,375,375,500
70,76,78,71,78,373,373,500
70,77,70,73,73,363,363,500
72,74,77,75,74,372,372,500
73,76,77,70,75,371,371,500
70,70,71,77,74,362,362,500
74,71,78,70,76,369,369,500
71,74,73,78,72,368,368,500
70,76,74,73,70,363,363,500
78,71,72,73,76,370,370,500
70,75,71,72,71,359,359,500
72,77,70,73,72,364,364,500
70,78,72,71,74,365,365,500
76,72,76,73,70,367,367,500
75,70,76,72,76,369,369,500
75,72,77,76,73,373,373,500
77,75,72,71,74,369,369,500
72,74,73,76,72,367,367,500
70,72,73,74,77,366,366,500
77,77,75,74,76,379,379,500
75,70,76,70,76,367,367,500
76,78,70,78,76,378,378,500
71,75,72,73,77,368,368,500
78,77,76,72,70,373,373,500
76,78,75,71,74,374,374,500
75,70,72,72,76,365,365,500
71,74,77,72,76,370,370,500
75,70,73,76,76,370,370,500
71,73,70,72,76,362,362,500
72,77,70,78,74,371,371,500
78,76,71,77,77,379,379,500
70,72,77,72,74,365,365,500
75,74,76,70,78,373,373,500
70,72,71,71,77,361,361,500
78,74,76,73,78,379,379,500
70,73,71,71,74,359,359,500
71,74,77,73,71,366,366,500
72,77,73,76,77,375,375,500
75,70,75,77,74,371,371,500
71,75,76,71,76,369,369,500
70,71,74,70,71,356,356,500
76,72,73,78,75,374,374,500
75,74,77,75,77,378,378,500
77,75,73,77,71,373,373,500
72,70,78,72,75,367,367,500
77,74,78,78,72,379,379,500
72,77,78,73,76,376,376,500
78,71,78,71,71,369,369,500
74,77,71,70,77,369,369,500
70,72,70,77,73,362,362,500
78,73,73,75,72,371,371,500
77,73,72,78,75,375,375,500
74,74,75,77,78,378,378,500
78,75,71,75,74,373,373,500
73,74,73,73,70,363,363,500
78,70,75,71,75,369,369,500
78,73,73,75,71,370,370,500
71,70,75,71,74,361,361,500
73,76,71,76,76,372,372,500
75,75,70,72,70,362,362,500
74,70,72,77,77,370,370,500
77,73,76,76,78,380,380,500
71,71,71,75,70,358,358,500
70,70,77,70,76,363,363,500
77,77,78,72,77,381,381,500
70,73,73,76,73,365,365,500
76,74,72,73,73,368,368,500
75,70,72,71,78,366,366,500
78,77,77,71,71,374,374,500
72,74,73,78,71,368,368,500
72,71,77,74,76,370,370,500
70,70,75,77,75,367,367,500
76,71,71,70,78,366,366,500
73,75,72,73,73,366,366,500
75,78,78,71,71,373,373,500
77,73,72,75,72,369,369,500
75,74,77,77,75,378,378,500
78,75,70,71,71,365,365,500
74,70,73,74,76,367,367,500
77,72,73,71,72,365,365,500
75,71,72,75,70,363,363,500
72,72,72,70,70,356,356,500
76,70,78,77,76,377,377,500
76,75,72,74,70,367,367,500
71,77,71,74,77,370,370,500
78,72,78,75,76,379,379,500
74,74,78,71,77,374,374,500
70,78,76,71,76,371,371,500
77,72,73,77,76,375,375,500
72,71,76,76,77,372,372,500
77,70,77,78,78,380,380,500
73,77,73,72,70,365,365,500
75,76,71,78,70,370,370,500
71,75,71,72,77,366,366,500
72,74,70,72,75,363,363,500
75,71,72,73,72,363,363,500
76,76,75,77,76,380,380,500
77,71,71,75,73,367,367,500
73,78,78,77,77,383,383,500
74,74,75,71,75,369,369,500
74,70,76,74,74,368,368,500
76,76,70,77,78,377,377,500
71,77,76,73,73,370,370,500
76,71,77,74,74,372,372,500
76,77,72,70,76,371,371,500
72,70,73,78,76,369,369,500
78,72,77,70,74,371,371,500
71,72,74,71,75,363,363,500
73,73,72,78,77,373,373,500
74,72,77,72,77,372,372,500
78,73,74,74,75,374,374,500
70,77,73,71,73,364,364,500
73,73,70,71,75,362,362,500
72,70,70,76,75,363,363,500
72,71,70,77,72,362,362,500
75,72,77,78,72,374,374,500
71,73,75,74,76,369,369,500
71,77,78,71,71,368,368,500
76,74,75,76,71,372,372,500
77,76,78,75,74,380,380,500
78,74,74,71,70,367,367,500
70,76,71,75,70,362,362,500
70,76,77,77,76,376,376,500
77,78,74,76,77,382,382,500
74,73,77,78,75,377,377,500
73,76,71,76,76,372,372,500
71,73,72,73,71,360,360,500
78,72,78,78,73,379,379,500
70,77,77,73,72,369,369,500
78,70,70,76,71,365,365,500
70,78,72,74,70,364,364,500
73,77,70,75,74,369,369,500
78,78,71,72,73,372,372,500
70,72,71,73,70,356,356,500
71,70,77,72,70,360,360,500
76,77,70,78,71,372,372,500
78,75,75,71,77,376,376,500
74,73,75,70,73,365,365,500
74,77,71,73,74,369,369,500
74,74,74,76,71,369,369,500
73,73,71,71,75,363,363,500
74,72,73,73,75,367,367,500
76,72,74,73,70,365,365,500
72,77,73,73,70,365,365,500
70,76,76,75,78,375,375,500
71,70,77,78,72,368,368,500
78,78,75,77,72,380,380,500
73,71,72,78,76,370,370,500
77,71,72,75,78,373,373,500
75,76,77,76,73,377,377,500
74,73,70,75,76,368,368,500
70,77,77,77,70,371,371,500
75,77,71,74,75,372,372,500
74,71,71,72,78,366,366,500
75,72,70,72,76,365,365,500
73,74,78,74,77,376,376,500
75,71,75,77,71,369,369,500
72,71,78,75,71,367,367,500
78,73,71,74,78,374,374,500
77,74,71,77,76,375,375,500
71,72,70,77,74,364,364,500
78,70,72,73,70,363,363,500
77,73,75,71,71,367,367,500
77,72,76,76,78,379,379,500
77,78,70,77,73,375,375,500
73,73,78,72,73,369,369,500
74,73,73,78,75,373,373,500
73,71,70,70,76,360,360,500
75,75,74,70,70,364,364,500
70,74,73,76,77,370,370,500
70,75,76,73,73,367,367,500
78,77,70,71,72,368,368,500
76,74,77,72,73,372,372,500
71,76,70,77,72,366,366,500
74,73,71,72,77,367,367,500
74,71,70,78,73,366,366,500
74,72,76,72,70,364,364,500
77,76,71,75,77,376,376,500
77,76,78,70,75,376,376,500
75,77,71,73,78,374,374,500
74,75,78,77,71,375,375,500
71,75,74,77,71,368,368,500
76,74,71,78,70,369,369,500
71,78,76,75,77,377,377,500
78,77,76,71,71,373,373,500
78,78,73,71,70,370,370,500
73,70,73,78,70,364,364,500
76,78,78,74,78,384,384,500
74,72,78,71,71,366,366,500
73,76,71,70,77,367,367,500
78,75,70,76,77,376,376,500
71,70,72,77,70,360,360,500
78,71,73,78,73,373,373,500
72,76,71,74,77,370,370,500
75,72,70,70,77,364,364,500
77,77,75,73,77,379,379,500
75,77,72,75,74,373,373,500
71,76,74,72,70,363,363,500
76,70,77,70,77,370,370,500
72,75,78,75,78,378,378,500
74,73,75,72,76,370,370,500
74,78,71,77,74,374,374,500
75,77,72,72,72,368,368,500
70,77,75,74,72,368,368,500
72,71,77,71,70,361,361,500
72,77,72,75,70,366,366,500
75,77,75,77,77,381,381,500
71,78,78,72,75,374,374,500
75,72,73,76,72,368,368,500
72,75,74,76,78,375,375,500
78,78,72,72,72,372,372,500
78,76,75,77,72,378,378,500
74,74,77,73,70,368,368,500
75,74,72,71,73,365,365,500
75,77,72,74,74,372,372,500
72,71,75,76,70,364,364,500
77,75,74,74,75,375,375,500
74,72,77,70,72,365,365,500
75,75,78,74,75,377,377,500
73,78,75,74,76,376,376,500
72,77,74,78,72,373,373,500
78,73,71,74,73,369,369,500
70,78,75,72,77,372,372,500
74,73,74,76,72,369,369,500
74,76,71,73,72,366,366,500
77,72,70,77,73,369,369,500
74,74,73,75,70,366,366,500
72,73,78,77,78,378,378,500
75,70,76,71,76,368,368,500
73,74,75,70,70,362,362,500
74,77,78,72,78,379,379,500
72,73,73,72,72,362,362,500
78,75,73,72,73,371,371,500
78,70,71,73,73,365,365,500
71,73,70,77,74,365,365,500
77,74,78,70,72,371,371,500
70,73,76,72,70,361,361,500
78,75,71,74,74,372,372,500
73,75,72,76,73,369,369,500
75,72,71,76,77,371,371,500
74,78,71,75,75,373,373,500
74,70,71,73,70,358,358,500
75,71,77,77,72,372,372,500
71,76,74,72,72,365,365,500
77,70,74,70,76,367,367,500
77,71,72,72,70,362,362,500
76,74,71,71,76,368,368,500
72,71,71,78,78,370,370,500
74,77,75,74,72,372,372,500
78,78,75,77,72,380,380,500
72,72,73,70,73,360,360,500
74,73,77,73,71,368,368,500
72,72,72,78,70,364,364,500
77,74,71,73,72,367,367,500
76,75,77,74,75,377,377,500
78,70,75,75,70,368,368,500
76,76,70,74,70,366,366,500
73,71,71,77,72,364,364,500
78,76,71,78,72,375,375,500
77,72,72,73,76,370,370,500
75,74,73,75,77,374,374,500
73,73,77,72,76,371,371,500
74,70,74,72,76,366,366,500
75,75,70,71,76,367,367,500
73,71,75,70,74,363,363,500
78,78,73,71,70,370,370,500
74,74,76,75,73,372,372,500
75,78,74,71,75,373,373,500
70,72,76,72,78,368,368,500
74,70,70,74,70,358,358,500
78,74,73,72,76,373,373,500
73,72,70,74,72,361,361,500
73,75,74,74,72,368,368,500
76,70,73,78,73,370,370,500
72,73,74,71,77,367,367,500
70,74,75,74,78,371,371,500
76,78,70,72,77,373,373,500
71,75,75,77,74,372,372,500
72,78,73,75,78,376,376,500
72,71,72,78,74,367,367,500
71,70,77,75,74,367,367,500
74,75,78,74,74,375,375,500
78,74,73,74,74,373,373,500
73,70,70,75,78,366,366,500
72,73,73,76,76,370,370,500
76,73,78,78,73,378,378,500
71,75,74,78,76,374,374,500
78,74,72,71,77,372,372,500
70,71,73,76,71,361,361,500
73,71,73,78,73,368,368,500
73,75,78,73,72,371,371,500
74,73,77,75,71,370,370,500
74,78,74,76,70,372,372,500
75,77,76,72,78,378,378,500
72,73,76,72,70,363,363,500
71,78,77,74,73,373,373,500
76,70,71,72,77,366,366,500
76,73,75,72,72,368,368,500
75,71,72,73,75,366,366,500
70,72,75,77,74,368,368,500
76,78,78,74,73,379,379,500
71,76,78,72,75,372,372,500
74,76,72,76,78,376,376,500
71,78,75,77,73,374,374,500
77,74,72,77,71,371,371,500
75,70,77,77,78,377,377,500
72,78,74,74,70,368,368,500
75,75,75,75,71,371,371,500
78,73,72,78,75,376,376,500
76,72,71,76,71,366,366,500
70,74,77,74,74,369,369,500
76,73,77,71,78,375,375,500
77,72,78,73,72,372,372,500
78,73,71,76,78,376,376,500
73,74,71,74,72,364,364,500
73,78,74,73,73,371,371,500
76,78,76,73,77,380,380,500
70,76,70,74,78,368,368,500
70,74,78,73,74,369,369,500
76,78,78,75,77,384,384,500
76,72,77,77,75,377,377,500
73,76,74,75,76,374,374,500
73,71,77,71,72,364,364,500
75,71,71,75,76,368,368,500
75,70,76,72,70,363,363,500
74,77,74,72,73,370,370,500
72,76,76,74,75,373,373,500
73,71,72,70,74,360,360,500
71,77,74,71,75,368,368,500
73,76,76,75,73,373,373,500
72,78,75,76,74,375,375,500
72,77,75,75,74,373,373,500
76,76,77,75,70,374,374,500
72,72,70,73,76,363,363,500
73,74,77,73,71,368,368,500
76,75,73,73,75,372,372,500
75,77,71,72,76,371,371,500
75,76,70,72,72,365,365,500
76,76,71,75,73,371,371,500
74,72,75,74,71,366,366,500
78,76,76,76,72,378,378,500
76,74,76,74,77,377,377,500
73,70,75,74,76,368,368,500
73,77,71,74,71,366,366,500
73,71,78,74,72,368,368,500
77,77,77,78,72,381,381,500
71,77,78,75,76,377,377,500
70,78,71,70,73,362,362,500
78,76,78,74,74,380,380,500
77,72,72,71,71,363,363,500
73,73,72,73,72,363,363,500
78,71,74,74,78,375,375,500
72,73,70,72,74,361,361,500
72,70,71,76,70,359,359,500
74,73,73,74,75,369,369,500
71,72,71,78,77,369,369,500
72,77,77,71,77,374,374,500
78,72,74,78,78,380,380,500
77,76,71,76,71,371,371,500
77,78,73,71,76,375,375,500
76,72,75,73,76,372,372,500
78,73,71,78,73,373,373,500
78,76,78,74,78,384,384,500
75,76,78,78,72,379,379,500
73,78,74,74,71,370,370,500
71,73,73,76,78,371,371,500
70,72,73,70,76,361,361,500
70,71,76,75,71,363,363,500
74,71,74,74,77,370,370,500
70,78,75,71,74,368,368,500
78,72,71,74,72,367,367,500
76,70,72,77,73,368,368,500
76,70,75,73,70,364,364,500
78,72,77,70,74,371,371,500
77,75,78,74,78,382,382,500
75,70,73,78,72,368,368,500
72,72,77,70,74,365,365,500
75,70,76,74,74,369,369,500
71,71,75,75,77,369,369,500
70,74,74,74,74,366,366,500
74,72,78,74,74,372,372,500
70,73,70,76,78,367,367,500
72,77,73,76,73,371,371,500
74,72,73,73,73,365,365,500
78,72,77,70,77,374,374,500
74,78,78,71,74,375,375,500
71,76,71,74,76,368,368,500
76,74,70,72,72,364,364,500
71,73,78,76,76,374,374,500
75,72,74,77,71,369,369,500
71,76,75,76,75,373,373,500
73,78,71,71,74,367,367,500
70,75,76,73,77,371,371,500
72,77,77,70,73,369,369,500
78,75,74,74,78,379,379,500
70,73,74,77,77,371,371,500
72,71,78,73,76,370,370,500
78,75,76,74,76,379,379,500
73,71,73,71,72,360,360,500
75,72,72,75,71,365,365,500
72,75,78,78,71,374,374,500
74,72,73,72,77,368,368,500
70,73,76,71,75,365,365,500
71,78,72,71,72,364,364,500
78,73,73,75,77,376,376,500
77,75,74,74,74,374,374,500
73,70,78,76,78,375,375,500
72,72,71,73,78,366,366,500
76,75,70,74,77,372,372,500
78,76,78,71,77,380,380,500
76,73,78,70,76,373,373,500
76,76,73,77,70,372,372,500
75,75,74,73,71,368,368,500
72,72,71,72,72,359,359,500
70,77,71,75,74,367,367,500
74,78,70,78,74,374,374,500
78,73,75,74,72,372,372,500
72,78,73,78,76,377,377,500
78,78,77,78,75,386,386,500
72,70,73,73,72,360,360,500
71,72,74,73,71,361,361,500
76,78,71,77,73,375,375,500
71,78,76,75,71,371,371,500
74,70,78,74,72,368,368,500
70,77,75,77,74,373,373,500
70,77,78,70,76,371,371,500
73,78,74,73,78,376,376,500
70,75,78,71,73,367,367,500
77,74,76,70,73,370,370,500
75,75,76,71,72,369,369,500
77,77,73,72,70,369,369,500
76,75,78,78,71,378,378,500
74,78,77,70,76,375,375,500
73,76,71,70,72,362,362,500
71,74,72,74,77,368,368,500
71,70,70,73,76,360,360,500
72,78,72,78,76,376,376,500
77,74,72,75,71,369,369,500
74,75,71,78,78,376,376,500
72,74,78,71,78,373,373,500
71,70,77,77,70,365,365,500
76,76,70,73,73,368,368,500
77,74,71,74,76,372,372,500
75,77,71,78,78,379,379,500
76,75,77,78,78,384,384,500
75,73,72,75,71,366,366,500
70,72,75,70,74,361,361,500
77,74,78,70,70,369,369,500
70,73,74,72,71,360,360,500
78,77,74,76,71,376,376,500
72,72,71,72,75,362,362,500
72,77,72,76,71,368,368,500
77,74,78,71,73,373,373,500
77,77,75,75,75,379,379,500
70,70,72,75,78,365,365,500
71,71,74,75,72,363,363,500
72,78,78,72,77,377,377,500
76,75,72,70,73,366,366,500
72,73,72,75,74,366,366,500
76,71,70,78,78,373,373,500
75,71,72,74,77,369,369,500
77,78,78,74,70,377,377,500
70,78,70,72,76,366,366,500
76,70,70,73,75,364,364,500
71,73,72,75,70,361,361,500
78,71,76,73,70,368,368,500
70,73,78,78,77,376,376,500
70,73,74,71,73,361,361,500
74,71,78,73,70,366,366,500
71,77,71,72,78,369,369,500
72,75,75,77,77,376,376,500
74,70,73,71,73,361,361,500
72,71,70,74,70,357,357,500
78,75,78,78,76,385,385,500
75,72,74,73,72,366,366,500
78,72,74,76,77,377,377,500
74,72,76,71,73,366,366,500
70,74,70,77,76,367,367,500
76,71,76,70,75,368,368,500
76,71,73,76,78,374,374,500
71,70,72,76,74,363,363,500
73,70,71,70,73,357,357,500
75,74,78,78,73,378,378,500
73,70,70,78,71,362,362,500
72,71,70,74,76,363,363,500
74,72,78,75,73,372,372,500
77,76,74,74,78,379,379,500
71,73,73,71,76,364,364,500
70,77,73,72,70,362,362,500
76,72,75,71,71,365,365,500
70,75,73,73,77,368,368,500
73,72,70,76,73,364,364,500
74,76,76,73,76,375,375,500
78,78,70,76,70,372,372,500
72,70,72,70,75,359,359,500
75,71,70,74,74,364,364,500
72,73,70,71,71,357,357,500
71,73,76,71,70,361,361,500
71,75,73,78,77,374,374,500
77,74,75,70,78,374,374,500
75,71,70,77,78,371,371,500
77,73,78,73,76,377,377,500
78,75,71,78,74,376,376,500
72,78,76,72,76,374,374,500
78,72,72,72,71,365,365,500
74,78,77,76,74,379,379,500
70,77,78,77,76,378,378,500
76,74,71,73,71,365,365,500
77,75,76,75,78,381,381,500
75,74,73,70,71,363,363,500
76,76,74,72,73,371,371,500
70,78,73,73,73,367,367,500
72,72,73,74,78,369,369,500
71,73,70,70,72,356,356,500
75,77,72,75,73,372,372,500
71,75,71,74,73,364,364,500
72,78,72,71,71,364,364,500
75,70,72,71,70,358,358,500
71,70,74,73,78,366,366,500
73,71,74,73,77,368,368,500
70,73,71,76,71,361,361,500
71,74,78,72,74,369,369,500
78,72,77,70,70,367,367,500
73,71,77,74,74,369,369,500
74,71,76,74,78,373,373,500
78,72,71,74,71,366,366,500
72,70,74,78,74,368,368,500
72,76,70,72,76,366,366,500
75,76,75,71,77,374,374,500
73,76,74,75,73,371,371,500
75,71,76,78,75,375,375,500
70,70,72,73,71,356,356,500
73,76,76,72,72,369,369,500
71,76,78,74,70,369,369,500
77,72,76,70,70,365,365,500
73,72,73,72,77,367,367,500
71,76,70,73,74,364,364,500
71,78,75,71,70,365,365,500
72,74,70,72,72,360,360,500
70,75,70,76,71,362,362,500
75,71,78,77,78,379,379,500
72,73,77,72,70,364,364,500
72,78,74,70,70,364,364,500
74,70,74,75,73,366,366,500
75,70,77,70,78,370,370,500
73,78,73,70,72,366,366,500
75,78,78,75,77,383,383,500
74,73,72,70,76,365,365,500
75,72,77,73,74,371,371,500
77,74,77,78,72,378,378,500
71,75,72,70,74,362,362,500
78,71,73,72,75,369,369,500
77,75,76,71,70,369,369,500
76,73,71,78,78,376,376,500
76,70,75,73,76,370,370,500
77,73,78,73,74,375,375,500
72,75,76,71,77,371,371,500
76,75,76,78,77,382,382,500
70,77,70,74,75,366,366,500
76,74,74,70,74,368,368,500
74,70,76,72,76,368,368,500
74,78,76,70,73,371,371,500
77,75,72,75,77,376,376,500
76,74,76,72,72,370,370,500
71,77,73,74,78,373,373,500
77,73,72,77,75,374,374,500
73,70,78,71,74,366,366,500
72,76,70,73,78,369,369,500
71,71,74,76,72,364,364,500
71,78,78,72,75,374,374,500
73,76,75,75,70,369,369,500
76,76,76,75,75,378,378,500
75,71,74,75,76,371,371,500
76,72,75,70,70,363,363,500
76,73,70,74,74,367,367,500
74,77,71,72,75,369,369,500
78,77,77,71,71,374,374,500
72,78,72,71,72,365,365,500
74,71,71,78,74,368,368,500
74,71,75,75,72,367,367,500
77,74,71,75,77,374,374,500
71,72,75,76,75,369,369,500
78,71,72,78,73,372,372,500
78,74,72,74,74,372,372,500
78,71,71,74,78,372,372,500
71,75,76,74,75,371,371,500
77,71,77,73,71,369,369,500
73,73,78,77,77,378,378,500
76,78,73,77,75,379,379,500
73,77,76,74,75,375,375,500
70,78,76,72,77,373,373,500
75,78,70,76,74,373,373,500
77,71,70,75,74,367,367,500
76,75,70,74,74,369,369,500
78,71,76,75,74,374,374,500
70,71,70,73,73,357,357,500
74,78,78,71,71,372,372,500
75,77,74,78,75,379,379,500
73,77,76,76,72,374,374,500
74,70,76,73,76,369,369,500
72,72,75,74,73,366,366,500
73,72,73,72,71,361,361,500
71,75,74,76,70,366,366,500
77,73,71,76,75,372,372,500
72,72,75,72,70,361,361,500
77,75,74,71,74,371,371,500
71,77,75,72,73,368,368,500
71,71,78,75,75,370,370,500
71,75,73,76,71,366,366,500
77,74,74,72,70,367,367,500
70,75,71,73,78,367,367,500
78,75,70,74,71,368,368,500
76,71,71,76,72,366,366,500
78,75,77,78,74,382,382,500
71,74,76,76,75,372,372,500
72,70,78,71,70,361,361,500
72,72,78,77,73,372,372,500
76,78,78,75,74,381,381,500
74,78,72,71,77,372,372,500
72,76,72,78,78,376,376,500
70,76,77,74,75,372,372,500
76,72,78,78,70,374,374,500
71,75,72,71,77,366,366,500
75,74,74,78,72,373,373,500
71,70,77,76,72,366,366,500
73,78,78,70,78,377,377,500
75,74,74,71,77,371,371,500
72,75,71,72,71,361,361,500
70,77,72,74,77,370,370,500
74,76,77,78,71,376,376,500
74,76,75,73,70,368,368,500
78,78,78,77,71,382,382,500
71,77,70,75,71,364,364,500
75,70,78,76,78,377,377,500
71,71,77,71,74,364,364,500
76,75,75,73,72,371,371,500
72,73,76,70,77,368,368,500
78,71,77,76,71,373,373,500
70,76,76,75,76,373,373,500
74,74,75,77,76,376,376,500
71,72,73,72,75,363,363,500
77,76,78,70,70,371,371,500
75,75,75,75,78,378,378,500
75,77,72,74,72,370,370,500
74,76,71,70,70,361,361,500
77,72,72,71,77,369,369,500
74,72,75,70,72,363,363,500
73,73,72,75,77,370,370,500
75,75,77,75,76,378,378,500
71,72,73,78,70,364,364,500
73,76,76,72,72,369,369,500
75,75,71,76,75,372,372,500
73,75,74,72,75,369,369,500
71,72,71,76,71,361,361,500
71,71,71,73,73,359,359,500
70,76,74,70,75,365,365,500
70,72,70,78,77,367,367,500
71,71,71,73,75,361,361,500
73,74,73,78,74,372,372,500
76,74,76,75,76,377,377,500
75,78,74,73,70,370,370,500
72,77,75,73,72,369,369,500
77,74,76,76,72,375,375,500
74,72,77,71,78,372,372,500
77,70,73,73,78,371,371,500
73,72,74,78,77,374,374,500
74,71,71,71,75,362,362,500
75,74,74,74,72,369,369,500
78,76,71,71,78,374,374,500
75,75,73,73,73,369,369,500
72,75,74,76,74,371,371,500
74,78,76,73,73,374,374,500
78,72,70,72,78,370,370,500
72,72,72,76,77,369,369,500
76,77,72,74,78,377,377,500
74,73,71,70,72,360,360,500
77,73,71,76,74,371,371,500
72,77,72,75,77,373,373,500
71,73,70,77,76,367,367,500
70,72,74,75,75,366,366,500
75,72,75,78,78,378,378,500
73,71,74,74,73,365,365,500
71,74,74,70,76,365,365,500
71,78,72,76,78,375,375,500
76,76,71,72,72,367,367,500
75,74,70,77,74,370,370,500
75,70,72,72,76,365,365,500
74,70,70,70,78,362,362,500
70,74,74,75,75,368,368,500
77,76,70,72,72,367,367,500
74,75,76,75,72,372,372,500
72,74,76,71,78,371,371,500
71,74,78,71,72,366,366,500
72,76,75,76,78,377,377,500
73,78,78,73,74,376,376,500
71,73,76,74,75,369,369,500
76,75,74,78,74,377,377,500
73,77,71,70,70,361,361,500
73,72,72,78,70,365,365,500
73,70,71,78,70,362,362,500
70,76,70,73,72,361,361,500
76,77,76,77,71,377,377,500
76,71,71,75,75,368,368,500
71,78,70,70,76,365,365,500
71,77,71,70,76,365,365,500
76,70,78,71,70,365,365,500
73,78,74,76,78,379,379,500
73,75,73,78,76,375,375,500
73,77,77,74,77,378,378,500
77,76,74,78,75,380,380,500
78,71,71,77,72,369,369,500
75,70,70,72,71,358,358,500
73,75,77,72,78,375,375,500
74,75,74,77,75,375,375,500
76,77,77,71,76,377,377,500
75,72,75,71,74,367,367,500
75,78,70,75,75,373,373,500
76,74,70,70,74,364,364,500
74,73,70,77,70,364,364,500
74,72,71,78,77,372,372,500
77,78,74,70,77,376,376,500
73,77,70,78,76,374,374,500
72,70,74,75,78,369,369,500
77,72,78,74,71,372,372,500
77,75,78,72,74,376,376,500
70,78,72,75,77,372,372,500
70,75,74,75,72,366,366,500
73,72,70,71,72,358,358,500
73,78,70,77,70,368,368,500
77,76,73,74,73,373,373,500
77,76,72,77,70,372,372,500
75,71,74,75,75,370,370,500
72,73,78,71,71,365,365,500
72,74,74,75,76,371,371,500
74,70,72,75,77,368,368,500
78,78,74,76,73,379,379,500
71,73,77,72,73,366,366,500
76,72,77,71,74,370,370,500
73,73,72,70,73,361,361,500
73,77,75,72,78,375,375,500
71,73,72,77,74,367,367,500
75,75,77,76,76,379,379,500
71,70,75,78,78,372,372,500
78,77,77,74,74,380,380,500
71,73,73,72,78,367,367,500
77,74,72,75,77,375,375,500
71,78,77,70,78,374,374,500
75,75,77,75,77,379,379,500
73,75,76,72,74,370,370,500
77,70,78,71,71,367,367,500
74,75,71,77,72,369,369,500
71,70,71,71,70,353,353,500
75,73,72,73,78,371,371,500
74,70,77,72,74,367,367,500
71,75,73,71,73,363,363,500
74,77,71,78,76,376,376,500
77,74,70,70,78,369,369,500
77,72,70,76,73,368,368,500
72,74,76,73,71,366,366,500
70,78,73,73,71,365,365,500
74,78,74,70,71,367,367,500
70,74,75,70,78,367,367,500
71,75,71,73,74,364,364,500
74,74,74,70,70,362,362,500
77,75,73,78,78,381,381,500
75,77,70,74,74,370,370,500
75,72,72,74,73,366,366,500
70,77,77,70,74,368,368,500
76,72,78,78,73,377,377,500
72,72,75,74,74,367,367,500
70,74,75,76,77,372,372,500
75,70,74,75,75,369,369,500
73,73,72,72,76,366,366,500
71,76,74,71,76,368,368,500
72,71,75,76,76,370,370,500
74,70,72,74,72,362,362,500
73,70,72,72,73,360,360,500
73,76,72,77,74,372,372,500
73,75,75,70,70,363,363,500
72,70,70,77,75,364,364,500
70,72,74,72,77,365,365,500
76,70,72,74,77,369,369,500
76,72,71,72,74,365,365,500
73,74,71,76,76,370,370,500
78,71,71,73,75,368,368,500
78,74,73,77,77,379,379,500
75,78,78,74,72,377,377,500
75,76,72,70,71,364,364,500
73,76,76,70,70,365,365,500
77,77,73,75,72,374,374,500
77,72,71,78,77,375,375,500
72,76,75,76,73,372,372,500
73,75,71,77,74,370,370,500
78,72,72,70,73,365,365,500
76,73,77,75,73,374,374,500
72,72,78,70,76,368,368,500
78,74,78,71,73,374,374,500
71,74,71,75,78,369,369,500
71,70,70,78,75,364,364,500
78,70,76,75,70,369,369,500
71,75,74,76,73,369,369,500
73,70,75,76,74,368,368,500
70,70,75,72,77,364,364,500
76,73,70,78,73,370,370,500
76,70,77,76,78,377,377,500
76,75,75,72,75,373,373,500
73,76,71,71,77,368,368,500
77,75,74,72,71,369,369,500
72,73,72,75,72,364,364,500
70,78,76,76,72,372,372,500
72,75,71,70,78,366,366,500
75,75,71,71,77,369,369,500
73,76,75,70,75,369,369,500
73,77,71,77,75,373,373,500
74,77,73,74,76,374,374,500
75,71,76,73,74,369,369,500
74,78,70,75,73,370,370,500
78,77,72,73,73,373,373,500
70,78,72,75,75,370,370,500
73,75,75,72,71,366,366,500
70,75,75,76,71,367,367,500
76,70,75,71,72,364,364,500
71,78,78,72,75,374,374,500
70,73,70,76,72,361,361,500
72,71,76,75,70,364,364,500
70,70,76,72,71,359,359,500
71,71,76,73,76,367,367,500
77,78,73,72,73,373,373,500
73,78,74,72,76,373,373,500
74,76,70,71,77,368,368,500
72,71,72,73,72,360,360,500
74,72,70,74,76,366,366,500
70,77,73,71,74,365,365,500
70,74,71,71,70,356,356,500
77,70,73,72,77,369,369,500
72,70,78,75,71,366,366,500
70,70,75,75,78,368,368,500
77,73,72,74,74,370,370,500
70,77,73,75,75,370,370,500
70,77,78,72,73,370,370,500
76,73,78,75,77,379,379,500
75,72,74,73,78,372,372,500
72,75,74,75,72,368,368,500
73,77,71,76,75,372,372,500
78,74,76,71,71,370,370,500
76,73,77,71,70,367,367,500
70,76,71,75,70,362,362,500
70,75,72,71,71,359,359,500
70,71,73,70,71,355,355,500
76,78,71,75,77,377,377,500
73,75,77,78,76,379,379,500
72,76,78,74,76,376,376,500
70,76,70,73,77,366,366,500
75,75,76,75,76,377,377,500
78,72,78,78,71,377,377,500
78,77,75,77,74,381,381,500
74,76,75,70,77,372,372,500
70,78,78,75,78,379,379,500
71,75,77,74,70,367,367,500
71,72,72,73,71,359,359,500
73,75,76,72,73,369,369,500
73,77,78,76,71,375,375,500
78,76,77,76,71,378,378,500
76,74,70,76,75,371,371,500
72,77,77,78,74,378,378,500
77,74,71,70,71,363,363,500
73,75,76,76,72,372,372,500
73,73,72,73,73,364,364,500
71,71,71,71,78,362,362,500
75,75,70,77,73,370,370,500
73,74,74,73,73,367,367,500
77,76,76,73,71,373,373,500
71,73,76,76,72,368,368,500
72,74,71,72,73,362,362,500
78,72,76,71,74,371,371,500
77,78,72,72,77,376,376,500
76,71,70,74,73,364,364,500
77,74,75,70,78,374,374,500
74,72,74,73,74,367,367,500
72,75,72,70,76,365,365,500
72,74,73,72,70,361,361,500
72,78,74,78,76,378,378,500
72,78,72,74,73,369,369,500
78,73,74,76,75,376,376,500
74,75,76,73,78,376,376,500
73,75,78,73,74,373,373,500
77,75,70,78,70,370,370,500
77,73,78,77,72,377,377,500
72,76,73,70,77,368,368,500
76,73,75,71,74,369,369,500
77,74,76,74,74,375,375,500
77,76,77,72,78,380,380,500
74,76,70,77,78,375,375,500
71,73,70,77,72,363,363,500
72,70,73,70,76,361,361,500
77,73,76,77,76,379,379,500
75,74,70,78,70,367,367,500
70,73,76,74,76,369,369,500
77,72,75,70,75,369,369,500
75,78,72,70,74,369,369,500
71,72,78,78,71,370,370,500
75,72,75,72,70,364,364,500
72,70,75,71,72,360,360,500
71,76,74,70,78,369,369,500
75,77,75,77,77,381,381,500
77,78,78,77,77,387,387,500
72,71,74,70,70,357,357,500
71,78,73,70,76,368,368,500
75,73,73,76,71,368,368,500
71,76,71,75,75,368,368,500
78,72,76,75,78,379,379,500
78,73,71,74,71,367,367,500
77,75,70,78,70,370,370,500
74,70,74,77,71,366,366,500
72,78,75,77,75,377,377,500
78,75,70,71,70,364,364,500
71,78,73,75,70,367,367,500
75,70,73,78,78,374,374,500
70,76,71,77,77,371,371,500
76,74,76,71,70,367,367,500
70,73,78,71,78,370,370,500
71,71,78,78,75,373,373,500
75,72,74,70,74,365,365,500
73,74,71,72,70,360,360,500
72,78,72,74,76,372,372,500
75,71,77,74,76,373,373,500
76,73,74,73,77,373,373,500
76,75,78,72,71,372,372,500
75,72,70,75,74,366,366,500
76,70,78,71,70,365,365,500
77,76,71,78,74,376,376,500
73,73,70,73,74,363,363,500
75,73,73,78,74,373,373,500
77,78,75,75,77,382,382,500
75,70,75,76,78,374,374,500
72,70,73,71,74,360,360,500
70,72,75,75,71,363,363,500
75,75,75,72,77,374,374,500
75,74,72,72,75,368,368,500
77,71,72,70,71,361,361,500
76,71,77,72,71,367,367,500
78,77,76,70,70,371,371,500
78,77,78,70,76,379,379,500
77,74,74,77,72,374,374,500
71,75,76,72,74,368,368,500
77,74,71,78,72,372,372,500
75,75,70,76,76,372,372,500
72,76,76,78,70,372,372,500
75,70,78,77,73,373,373,500
70,70,77,73,77,367,367,500
74,71,76,74,72,367,367,500
74,75,72,70,73,364,364,500
73,78,77,75,77,380,380,500
76,75,76,73,77,377,377,500
73,78,74,72,73,370,370,500
73,74,71,73,76,367,367,500
71,78,75,73,70,367,367,500
77,70,74,73,73,367,367,500
74,74,73,74,77,372,372,500
77,72,70,74,76,369,369,500
77,72,77,74,70,370,370,500
72,74,74,76,73,369,369,500
71,78,78,77,76,380,380,500
76,78,76,70,76,376,376,500
72,71,70,73,71,357,357,500
74,75,71,70,76,366,366,500
72,76,76,76,77,377,377,500
71,78,71,72,75,367,367,500
71,77,73,71,77,369,369,500
71,72,75,78,75,371,371,500
73,75,75,75,77,375,375,500
72,77,73,75,74,371,371,500
70,74,77,73,77,371,371,500
71,70,74,71,75,361,361,500
75,74,73,78,72,372,372,500
75,74,70,77,72,368,368,500
77,70,73,70,78,368,368,500
78,72,70,72,78,370,370,500
77,76,74,73,77,377,377,500
72,70,72,70,70,354,354,500
78,76,75,73,78,380,380,500
72,70,73,73,75,363,363,500
78,74,76,73,77,378,378,500
76,72,75,73,74,370,370,500
70,71,70,78,76,365,365,500
76,78,72,73,73,372,372,500
70,73,74,71,71,359,359,500
74,77,72,77,75,375,375,500
71,72,73,77,73,366,366,500
74,75,72,70,72,363,363,500
78,77,73,73,70,371,371,500
72,76,71,73,73,365,365,500
78,74,78,77,76,383,383,500
71,71,71,71,75,359,359,500
72,74,70,76,71,363,363,500
76,71,76,73,72,368,368,500
77,71,77,76,74,375,375,500
72,77,72,74,70,365,365,500
75,73,77,70,72,367,367,500
74,77,71,77,78,377,377,500
77,71,75,77,78,378,378,500
73,74,75,71,77,370,370,500
75,72,75,76,75,373,373,500
73,75,70,73,74,365,365,500
71,77,70,73,78,369,369,500
74,74,78,78,75,379,379,500
72,70,76,71,71,360,360,500
78,78,75,78,70,379,379,500
73,73,77,73,75,371,371,500
71,74,75,72,75,367,367,500
77,77,78,71,78,381,381,500
78,78,72,71,71,370,370,500
70,76,76,74,76,372,372,500
73,75,74,72,74,368,368,500
70,71,73,73,76,363,363,500
75,74,76,71,76,372,372,500
77,75,76,73,78,379,379,500
72,77,78,78,75,380,380,500
76,75,74,75,74,374,374,500
70,72,70,70,78,360,360,500
72,74,71,72,75,364,364,500
70,70,70,76,73,359,359,500
73,71,76,70,71,361,361,500
76,71,71,70,75,363,363,500
75,78,76,76,76,381,381,500
70,70,74,78,76,368,368,500
78,76,74,72,76,376,376,500
73,71,77,77,77,375,375,500
77,73,74,77,74,375,375,500
78,73,70,78,72,371,371,500
74,74,72,73,72,365,365,500
75,70,73,73,71,362,362,500
75,75,74,76,77,377,377,500
71,73,75,70,78,367,367,500
76,72,77,77,75,377,377,500
77,77,70,76,75,375,375,500
72,74,70,76,73,365,365,500
71,73,74,77,73,368,368,500
77,73,72,77,70,369,369,500
76,74,77,71,76,374,374,500
78,75,71,74,70,368,368,500
75,77,78,70,75,375,375,500
75,75,78,77,72,377,377,500
77,70,74,74,75,370,370,500
76,78,78,74,72,378,378,500
77,71,70,77,78,373,373,500
73,72,75,76,77,373,373,500
78,75,73,76,70,372,372,500
72,75,72,72,72,363,363,500
75,75,78,76,71,375,375,500
76,78,73,74,77,378,378,500
72,78,73,77,78,378,378,500
75,73,75,71,72,366,366,500
74,72,75,74,77,372,372,500
71,73,71,78,76,369,369,500
70,73,78,76,76,373,373,500
78,74,78,70,74,374,374,500
76,70,77,73,72,368,368,500
78,78,75,76,78,385,385,500
74,71,75,75,75,370,370,500
73,74,77,78,76,378,378,500
76,77,74,73,74,374,374,500
76,74,74,72,77,373,373,500
78,74,74,76,76,378,378,500
74,74,77,76,71,372,372,500
75,75,75,71,72,368,368,500
71,74,71,74,70,360,360,500
76,71,75,72,74,368,368,500
77,74,76,70,78,375,375,500
78,73,72,71,72,366,366,500
73,72,72,75,70,362,362,500
70,73,73,72,72,360,360,500
70,70,73,76,74,363,363,500
78,70,73,73,78,372,372,500
71,76,71,77,77,372,372,500
72,74,75,76,76,373,373,500
70,78,73,74,77,372,372,500
76,75,78,75,75,379,379,500
74,70,76,73,78,371,371,500
77,75,77,78,75,382,382,500
71,72,75,71,74,363,363,500
76,72,74,76,78,376,376,500
74,74,73,73,75,369,369,500
74,75,74,74,72,369,369,500
72,76,77,77,75,377,377,500
74,77,76,78,74,379,379,500
78,72,76,73,77,376,376,500
71,74,74,74,76,369,369,500
73,77,76,74,78,378,378,500
74,73,75,73,72,367,367,500
77,74,72,71,78,372,372,500
74,74,76,72,76,372,372,500
76,73,75,73,75,372,372,500
73,71,74,76,78,372,372,500
75,72,76,75,77,375,375,500
72,73,74,72,72,363,363,500
78,75,70,75,75,373,373,500
74,74,75,76,71,370,370,500
76,77,76,72,70,371,371,500
70,75,77,78,73,373,373,500
76,76,77,71,70,370,370,500
74,77,72,72,74,369,369,500
73,73,78,76,74,374,374,500
75,74,77,75,76,377,377,500
78,74,78,71,72,373,373,500
78,76,76,72,77,379,379,500
76,75,73,74,72,370,370,500
71,70,70,76,78,365,365,500
73,72,74,73,77,369,369,500
75,75,71,70,77,368,368,500
77,72,78,74,77,378,378,500
73,75,71,74,71,364,364,500
74,74,70,78,75,371,371,500
72,72,71,72,75,362,362,500
78,77,72,73,74,374,374,500
72,77,74,75,74,372,372,500
75,73,70,75,70,363,363,500
78,73,70,70,70,361,361,500
77,71,76,74,78,376,376,500
76,70,76,71,72,365,365,500
71,74,76,71,76,368,368,500
78,71,78,78,70,375,375,500
74,78,74,70,76,372,372,500
70,71,71,78,74,364,364,500
75,73,76,71,75,370,370,500
72,75,73,74,76,370,370,500
70,74,75,77,73,369,369,500
76,75,74,74,76,375,375,500
78,70,74,70,76,368,368,500
74,74,72,75,71,366,366,500
74,75,78,76,78,381,381,500
73,77,72,72,76,370,370,500
72,76,72,71,74,365,365,500
78,74,77,78,73,380,380,500
75,75,72,72,78,372,372,500
78,73,77,70,74,372,372,500
78,70,76,78,74,376,376,500
78,73,77,75,74,377,377,500
76,78,70,72,74,370,370,500
72,78,73,77,77,377,377,500
71,77,74,70,72,364,364,500
70,75,71,70,75,361,361,500
70,73,70,71,78,362,362,500
78,70,74,77,76,375,375,500
74,78,76,72,73,373,373,500
70,71,72,72,75,360,360,500
73,73,76,72,73,367,367,500
70,76,75,72,74,367,367,500
78,73,75,75,76,377,377,500
78,75,75,77,70,375,375,500
75,73,73,73,70,364,364,500
77,73,78,72,77,377,377,500
76,70,76,76,73,371,371,500
75,74,74,72,76,371,371,500
77,71,76,72,75,371,371,500
70,73,70,77,77,367,367,500
75,70,72,78,77,372,372,500
77,76,75,76,75,379,379,500
70,71,73,77,74,365,365,500
78,78,74,75,72,377,377,500
71,73,71,74,74,363,363,500
70,70,74,74,71,359,359,500
70,72,77,77,73,369,369,500
71,70,73,77,78,369,369,500
71,75,73,72,71,362,362,500
77,71,73,77,72,370,370,500
77,73,72,77,71,370,370,500
71,76,78,70,76,371,371,500
77,72,76,75,71,371,371,500
71,71,74,75,74,365,365,500
70,71,72,78,74,365,365,500
76,76,77,77,77,383,383,500
70,70,71,76,75,362,362,500
73,75,71,70,76,365,365,500
78,78,70,78,70,374,374,500
73,77,77,72,76,375,375,500
73,70,75,73,73,364,364,500
70,76,75,78,76,375,375,500
70,72,75,78,77,372,372,500
71,71,75,71,72,360,360,500
77,75,73,72,72,369,369,500
72,77,71,71,73,364,364,500
77,73,74,76,76,376,376,500
77,70,70,72,70,359,359,500
75,76,75,71,72,369,369,500
72,73,78,73,73,369,369,500
74,70,70,74,77,365,365,500
70,78,75,72,72,367,367,500
73,70,70,75,76,364,364,500
70,77,71,76,76,370,370,500
70,74,72,78,73,367,367,500
72,70,71,78,75,366,366,500
74,77,76,77,70,374,374,500
73,71,77,76,74,371,371,500
74,71,72,73,75,365,365,500
78,77,71,72,70,368,368,500
73,74,72,75,76,370,370,500
78,77,76,78,77,386,386,500
73,73,70,78,71,365,365,500
77,74,73,74,78,376,376,500
74,72,71,78,73,368,368,500
73,72,77,72,71,365,365,500
78,73,75,77,72,375,375,500
72,70,78,78,75,373,373,500
74,78,70,72,75,369,369,500
70,72,76,76,77,371,371,500
73,76,70,74,77,370,370,500
76,70,76,75,72,369,369,500
78,75,73,75,70,371,371,500
78,72,78,78,78,384,384,500
75,75,75,70,77,372,372,500
74,72,78,72,75,371,371,500
74,73,76,72,71,366,366,500
78,73,70,73,71,365,365,500
73,73,75,71,78,370,370,500
70,77,76,72,78,373,373,500
76,71,71,75,75,368,368,500
75,73,76,75,77,376,376,500
78,75,70,76,78,377,377,500
77,75,70,78,75,375,375,500
78,73,74,76,76,377,377,500
70,74,70,77,70,361,361,500
76,74,78,77,72,377,377,500
76,72,74,77,74,373,373,500
77,72,78,77,75,379,379,500
73,76,73,77,71,370,370,500
71,71,73,77,77,369,369,500
72,76,73,78,78,377,377,500
76,75,71,76,72,370,370,500
75,76,70,75,73,369,369,500
70,71,77,73,72,363,363,500
78,74,72,70,71,365,365,500
78,78,76,76,72,380,380,500
73,75,71,76,73,368,368,500
72,74,78,70,74,368,368,500
73,77,73,71,76,370,370,500
70,77,71,75,76,369,369,500
72,75,72,75,71,365,365,500
73,73,77,72,78,373,373,500
74,75,73,76,76,374,374,500
78,75,71,75,73,372,372,500
71,73,77,78,78,377,377,500
73,78,73,71,73,368,368,500
77,78,70,75,72,372,372,500
74,70,70,78,70,362,362,500
77,71,73,70,71,362,362,500
77,72,71,78,77,375,375,500
71,70,74,74,77,366,366,500
73,75,73,73,77,371,371,500
77,77,70,74,70,368,368,500
70,77,71,72,78,368,368,500
70,75,70,74,73,362,362,500
72,78,71,73,78,372,372,500
75,73,73,75,75,371,371,500
72,78,72,75,71,368,368,500
70,72,75,74,75,366,366,500
71,78,78,76,70,373,373,500
73,72,76,70,74,365,365,500
71,78,76,73,74,372,372,500
75,70,77,72,71,365,365,500
77,75,75,76,76,379,379,500
74,76,76,74,75,375,375,500
76,71,77,77,74,375,375,500
78,74,77,71,76,376,376,500
75,72,70,73,77,367,367,500
72,76,70,75,74,367,367,500
74,75,73,72,78,372,372,500
71,73,76,73,73,366,366,500
75,74,72,71,74,366,366,500
71,72,72,74,74,363,363,500
76,70,78,75,77,376,376,500
73,73,77,73,73,369,369,500
74,76,71,76,75,372,372,500
72,71,70,76,73,362,362,500
71,72,71,73,70,357,357,500
78,77,73,77,73,378,378,500
75,76,71,72,75,369,369,500
70,78,78,76,70,372,372,500
75,71,70,76,73,365,365,500
71,73,70,76,70,360,360,500
72,78,75,75,76,376,376,500
78,71,75,77,70,371,371,500
77,70,70,70,75,362,362,500
76,70,74,76,76,372,372,500
74,77,73,73,78,375,375,500
74,78,70,74,77,373,373,500
72,73,71,70,70,356,356,500
76,70,78,78,73,375,375,500
71,76,75,74,74,370,370,500
77,73,78,76,71,375,375,500
75,74,74,71,77,371,371,500
72,71,71,70,75,359,359,500
76,71,74,70,70,361,361,500
75,76,77,73,73,374,374,500
77,73,73,78,73,374,374,500
76,73,74,76,78,377,377,500
71,76,77,70,73,367,367,500
78,71,71,74,70,364,364,500
78,77,77,70,78,380,380,500
72,78,76,73,73,372,372,500
76,74,75,71,74,370,370,500
73,71,72,76,70,362,362,500
76,73,73,77,70,369,369,500
75,70,71,72,78,366,366,500
75,76,77,76,71,375,375,500
71,75,77,70,71,364,364,500
70,71,72,73,78,364,364,500
78,73,78,72,70,371,371,500
72,74,76,71,75,368,368,500
78,77,75,78,73,381,381,500
73,76,77,75,71,372,372,500
71,76,77,75,76,375,375,500
73,75,75,74,76,373,373,500
76,71,77,72,75,371,371,500
74,70,76,78,71,369,369,500
75,73,73,71,78,370,370,500
71,77,76,72,76,372,372,500
71,73,75,77,72,368,368,500
77,76,72,72,75,372,372,500
78,76,74,73,73,374,374,500
77,73,71,73,73,367,367,500
72,70,78,78,75,373,373,500
76,77,73,78,71,375,375,500
71,76,73,72,70,362,362,500
70,78,78,75,76,377,377,500
78,78,74,72,77,379,379,500
75,74,76,71,77,373,373,500
77,77,75,77,76,382,382,500
75,76,78,70,78,377,377,500
70,70,78,76,78,372,372,500
78,71,78,76,71,374,374,500
77,76,73,71,77,374,374,500
70,73,71,75,78,367,367,500
77,71,71,75,71,365,365,500
72,78,74,76,70,370,370,500
76,71,73,75,71,366,366,500
73,72,76,70,75,366,366,500
71,75,73,76,74,369,369,500
75,78,74,71,71,369,369,500
76,76,71,75,76,374,374,500
73,74,70,78,71,366,366,500
73,73,73,72,78,369,369,500
77,78,74,77,70,376,376,500
77,77,78,73,77,382,382,500
78,73,70,76,73,370,370,500
78,71,74,78,75,376,376,500
73,76,74,74,70,367,367,500
75,76,72,70,74,367,367,500
76,76,72,72,76,372,372,500
78,74,71,75,77,375,375,500
75,70,72,77,77,371,371,500
78,77,78,76,72,381,381,500
78,76,76,70,77,377,377,500
71,74,77,74,77,373,373,500
74,72,71,75,77,369,369,500
76,73,77,73,71,370,370,500
70,74,78,75,78,375,375,500
72,73,71,75,74,365,365,500
72,71,73,77,70,363,363,500
74,70,76,78,72,370,370,500
71,74,72,76,70,363,363,500
70,72,78,71,74,365,365,500
75,77,72,73,76,373,373,500
75,78,78,77,75,383,383,500
74,76,76,77,76,379,379,500
78,73,76,76,70,373,373,500
71,70,70,74,71,356,356,500
71,75,74,70,73,363,363,500
78,78,72,75,77,380,380,500
77,70,76,70,74,367,367,500
74,73,76,73,77,373,373,500
75,73,78,70,71,367,367,500
76,71,73,73,76,369,369,500
77,76,70,72,74,369,369,500
71,72,76,76,74,369,369,500
74,73,70,72,73,362,362,500
71,73,71,76,70,361,361,500
76,77,76,78,75,382,382,500
70,75,73,78,70,366,366,500
76,74,73,70,73,366,366,500
78,73,75,71,74,371,371,500
72,77,70,75,72,366,366,500
75,74,76,70,74,369,369,500
71,71,72,76,76,366,366,500
74,70,70,73,73,360,360,500
77,73,77,71,70,368,368,500
75,72,77,72,78,374,374,500
73,70,70,77,70,360,360,500
77,77,70,78,70,372,372,500
76,75,71,71,76,369,369,500
71,74,77,74,78,374,374,500
70,72,70,78,73,363,363,500
71,72,74,74,74,365,365,500
77,73,73,70,75,368,368,500
72,72,75,75,71,365,365,500
75,70,70,71,74,360,360,500
72,77,78,72,70,369,369,500
73,74,72,76,74,369,369,500
78,70,73,71,74,366,366,500
76,77,70,77,77,377,377,500
71,78,72,74,75,370,370,500
74,70,74,78,70,366,366,500
76,77,73,76,77,379,379,500
76,71,78,70,70,365,365,500
76,73,71,73,74,367,367,500
77,71,72,76,77,373,373,500
70,77,78,77,77,379,379,500
76,77,78,71,77,379,379,500
78,77,72,74,72,373,373,500
78,78,70,77,78,381,381,500
78,78,70,71,76,373,373,500
70,70,77,71,74,362,362,500
73,76,77,74,77,377,377,500
77,78,75,70,77,377,377,500
75,75,72,71,75,368,368,500
71,72,70,78,74,365,365,500
74,78,71,72,77,372,372,500
75,73,76,75,75,374,374,500
72,73,74,70,78,367,367,500
70,77,74,73,70,364,364,500
78,74,78,77,78,385,385,500
72,70,73,76,75,366,366,500
72,78,74,73,74,371,371,500
72,72,70,76,76,366,366,500
70,77,78,71,75,371,371,500
73,76,75,72,77,373,373,500
78,74,77,70,74,373,373,500
75,70,78,74,75,372,372,500
75,70,76,70,74,365,365,500
77,76,78,76,75,382,382,500
72,78,76,75,70,371,371,500
70,78,75,72,74,369,369,500
77,78,77,78,72,382,382,500
76,71,71,74,73,365,365,500
75,73,73,75,70,366,366,500
74,74,76,70,76,370,370,500
70,76,74,77,74,371,371,500
75,72,71,74,73,365,365,500
72,72,70,70,75,359,359,500
74,77,72,75,71,369,369,500
70,72,70,70,78,360,360,500
74,70,73,74,74,365,365,500
70,78,71,76,78,373,373,500
70,72,70,75,72,359,359,500
77,76,76,77,73,379,379,500
76,70,70,74,72,362,362,500
74,77,76,76,76,379,379,500
76,70,76,73,76,371,371,500
74,78,72,71,72,367,367,500
72,71,78,73,72,366,366,500
75,73,78,71,74,371,371,500
73,76,72,77,74,372,372,500
76,75,70,74,78,373,373,500
70,70,70,75,70,355,355,500
77,74,75,73,76,375,375,500
76,75,73,72,74,370,370,500
75,76,77,75,78,381,381,500
72,72,72,77,74,367,367,500
73,75,71,72,75,366,366,500
75,74,75,70,77,371,371,500
74,78,78,76,77,383,383,500
70,71,76,73,76,366,366,500
74,78,75,72,70,369,369,500
78,75,78,74,76,381,381,500
72,71,73,76,70,362,362,500
71,74,74,75,72,366,366,500
71,77,70,77,76,371,371,500
76,73,75,70,70,364,364,500
73,71,71,75,70,360,360,500
73,76,73,78,77,377,377,500
70,75,72,74,74,365,365,500
73,74,72,75,70,364,364,500
75,74,70,76,74,369,369,500
77,72,71,71,77,368,368,500
74,71,77,75,75,372,372,500
76,78,78,73,72,377,377,500
75,70,74,73,74,366,366,500
76,70,77,75,71,369,369,500
76,74,78,78,71,377,377,500
73,75,76,70,76,370,370,500
74,78,75,77,76,380,380,500
77,75,75,76,77,380,380,500
73,71,78,72,74,368,368,500
72,70,78,73,73,366,366,500
75,70,76,78,73,372,372,500
72,78,71,75,74,370,370,500
70,78,76,73,72,369,369,500
75,70,71,76,78,370,370,500
70,78,74,76,73,371,371,500
74,72,77,75,72,370,370,500
76,78,74,73,71,372,372,500
73,75,78,73,77,376,376,500
75,74,78,70,73,370,370,500
70,72,72,72,70,356,356,500
75,72,70,70,73,360,360,500
75,74,77,71,72,369,369,500
73,74,71,76,77,371,371,500
70,71,76,78,75,370,370,500
74,71,74,73,70,362,362,500
72,74,74,71,71,362,362,500
73,75,77,77,74,376,376,500
72,78,74,76,76,376,376,500
77,73,75,76,74,375,375,500
78,71,73,75,74,371,371,500
75,73,72,76,75,371,371,500
73,77,71,72,74,367,367,500
77,72,70,74,78,371,371,500
76,71,75,71,77,370,370,500
73,70,72,71,71,357,357,500
71,73,78,70,70,362,362,500
78,75,70,72,74,369,369,500
74,78,78,75,75,380,380,500
77,75,77,76,73,378,378,500
71,75,74,77,76,373,373,500
74,77,78,74,78,381,381,500
73,72,70,77,76,368,368,500
77,77,74,71,72,371,371,500
73,72,77,71,72,365,365,500
70,70,70,76,73,359,359,500
70,76,71,73,78,368,368,500
70,72,72,70,78,362,362,500
74,75,70,71,73,363,363,500
73,70,77,71,73,364,364,500
73,73,78,71,78,373,373,500
73,72,71,72,76,364,364,500
71,70,70,77,76,364,364,500
71,77,76,73,75,372,372,500
75,73,74,73,74,369,369,500
71,70,76,77,70,364,364,500
76,72,73,75,75,371,371,500
70,74,73,73,74,364,364,500
75,77,71,74,71,368,368,500
78,70,76,72,71,367,367,500
74,72,70,77,73,366,366,500
78,71,75,74,71,369,369,500
76,75,75,76,77,379,379,500
71,71,71,73,73,359,359,500
78,75,78,71,72,374,374,500
74,73,78,74,73,372,372,500
71,73,74,76,77,371,371,500
73,70,78,73,70,364,364,500
70,75,73,77,70,365,365,500
78,74,74,77,76,379,379,500
71,73,71,77,73,365,365,500
77,71,70,71,73,362,362,500
76,72,73,73,75,369,369,500
77,70,78,75,77,377,377,500
75,78,76,78,71,378,378,500
74,77,70,74,73,368,368,500
78,76,71,70,71,366,366,500
72,73,75,74,76,370,370,500
70,78,76,71,73,368,368,500
75,73,77,72,73,370,370,500
77,74,72,76,71,370,370,500
73,72,74,71,70,360,360,500
78,74,75,71,76,374,374,500
72,72,72,74,76,366,366,500
75,75,72,71,76,369,369,500
73,77,77,76,73,376,376,500
75,71,70,72,73,361,361,500
76,75,77,74,71,373,373,500
78,76,71,76,74,375,375,500
76,73,76,72,75,372,372,500
72,70,77,70,78,367,367,500
72,75,73,78,76,374,374,500
75,74,76,76,70,371,371,500
70,78,70,73,76,367,367,500
73,75,73,70,76,367,367,500
75,76,76,71,78,376,376,500
78,77,74,70,78,377,377,500
72,71,76,76,77,372,372,500
75,75,74,74,77,375,375,500
71,72,75,72,77,367,367,500
76,75,77,76,70,374,374,500
78,74,75,77,71,375,375,500
78,77,71,70,78,374,374,500
75,71,75,73,70,364,364,500
78,73,76,70,78,375,375,500
75,75,73,71,75,369,369,500
78,72,72,71,70,363,363,500
77,75,76,76,78,382,382,500
74,71,72,76,75,368,368,500
71,74,71,78,78,372,372,500
72,78,74,76,74,374,374,500
75,75,70,73,76,369,369,500
75,72,71,78,74,370,370,500
72,72,75,75,73,367,367,500
77,71,70,73,75,366,366,500
74,74,78,75,77,378,378,500
72,72,70,77,72,363,363,500
77,78,74,73,72,374,374,500
75,76,72,72,78,373,373,500
73,75,72,78,73,371,371,500
73,76,75,74,74,372,372,500
78,71,71,73,78,371,371,500
70,78,70,70,70,358,358,500
75,70,74,70,71,360,360,500
77,70,74,74,70,365,365,500
72,71,71,71,71,356,356,500
78,73,74,71,74,370,370,500
78,73,76,75,77,379,379,500
73,75,78,71,77,374,374,500
71,72,75,70,74,362,362,500
77,73,72,76,71,369,369,500
76,73,76,71,72,368,368,500
74,75,75,70,77,371,371,500
71,73,73,71,72,360,360,500
74,73,70,78,75,370,370,500
71,71,72,73,72,359,359,500
76,71,71,72,78,368,368,500
75,72,71,73,75,366,366,500
71,72,77,76,76,372,372,500
70,70,73,73,73,359,359,500
72,74,76,75,71,368,368,500
71,77,78,75,73,374,374,500
73,71,70,78,71,363,363,500
76,71,71,74,72,364,364,500
75,70,72,76,73,366,366,500
75,74,73,70,77,369,369,500
78,78,77,75,71,379,379,500
70,76,72,76,78,372,372,500
78,78,74,74,74,378,378,500
71,76,74,70,77,368,368,500
72,73,74,77,75,371,371,500
75,70,75,76,70,366,366,500
72,72,72,73,71,360,360,500
75,73,75,78,76,377,377,500
78,76,74,73,70,371,371,500
74,78,71,78,75,376,376,500
77,72,77,76,72,374,374,500
72,73,75,77,75,372,372,500
73,77,72,70,78,370,370,500
74,75,76,76,71,372,372,500
73,73,74,73,70,363,363,500
74,78,74,76,72,374,374,500
72,76,77,71,75,371,371,500
70,71,76,76,74,367,367,500
77,76,73,78,70,374,374,500
75,70,78,72,78,373,373,500
74,75,72,74,76,371,371,500
70,74,73,76,76,369,369,500
78,70,73,77,75,373,373,500
76,77,78,74,77,382,382,500
77,72,72,75,70,366,366,500
73,76,77,77,71,374,374,500
73,73,74,76,75,371,371,500
71,73,70,74,77,365,365,500
75,70,77,72,77,371,371,500
74,72,76,72,71,365,365,500
70,72,72,75,75,364,364,500
71,73,76,75,73,368,368,500
71,76,74,78,73,372,372,500
75,76,73,78,75,377,377,500
77,76,72,74,74,373,373,500
75,75,71,75,73,369,369,500
70,71,77,70,75,363,363,500
78,74,78,71,72,373,373,500
71,74,71,77,71,364,364,500
71,76,72,74,74,367,367,500
75,70,73,72,70,360,360,500
78,78,72,78,77,383,383,500
77,70,75,77,73,372,372,500
74,75,76,73,75,373,373,500
70,75,72,77,77,371,371,500
75,78,70,70,72,365,365,500
77,70,73,70,71,361,361,500
74,75,73,76,75,373,373,500
72,72,71,76,71,362,362,500
72,74,77,76,78,377,377,500
77,70,76,70,71,364,364,500
78,74,71,77,78,378,378,500
76,74,72,74,71,367,367,500
70,72,76,75,73,366,366,500
76,77,74,72,70,369,369,500
71,76,71,71,77,366,366,500
75,72,75,70,72,364,364,500
72,77,78,70,77,374,374,500
73,71,77,71,73,365,365,500
72,72,76,70,73,363,363,500
77,76,76,76,70,375,375,500
73,75,72,75,76,371,371,500
72,73,72,72,77,366,366,500
72,75,70,77,76,370,370,500
78,76,70,71,73,368,368,500
78,76,78,74,76,382,382,500
77,71,74,76,76,374,374,500
72,72,71,70,76,361,361,500
72,72,75,70,78,367,367,500
75,72,76,73,77,373,373,500
75,75,74,75,78,377,377,500
71,70,75,75,71,362,362,500
76,70,76,75,72,369,369,500
78,71,78,73,70,370,370,500
73,71,76,77,75,372,372,500
73,70,74,72,72,361,361,500
76,78,71,75,71,371,371,500
76,72,75,78,78,379,379,500
77,78,77,70,70,372,372,500
71,71,76,74,73,365,365,500
72,77,71,78,72,370,370,500
78,74,71,76,74,373,373,500
73,70,76,73,74,366,366,500
77,76,75,75,72,375,375,500
71,77,75,70,77,370,370,500
72,78,78,75,77,380,380,500
71,73,71,70,71,356,356,500
74,76,78,76,78,382,382,500
75,71,76,74,76,372,372,500
74,78,76,74,74,376,376,500
72,76,71,76,72,367,367,500
70,71,76,72,78,367,367,500
71,78,75,78,76,378,378,500
72,70,73,76,78,369,369,500
72,78,75,76,78,379,379,500
78,77,74,74,78,381,381,500
78,75,78,73,76,380,380,500
78,70,70,75,77,370,370,500
71,74,74,74,71,364,364,500
71,77,74,72,75,369,369,500
75,78,78,72,76,379,379,500
73,77,70,76,78,374,374,500
76,74,76,71,73,370,370,500
75,74,72,70,72,363,363,500
74,73,75,76,77,375,375,500
74,72,76,78,70,370,370,500
71,78,70,78,70,367,367,500
75,73,72,71,74,365,365,500
76,72,75,70,74,367,367,500
73,71,74,73,78,369,369,500
74,74,73,71,78,370,370,500
73,70,72,74,70,359,359,500
70,78,75,74,73,370,370,500
72,78,78,75,72,375,375,500
71,76,74,75,72,368,368,500
74,76,78,70,78,376,376,500
74,70,71,78,75,368,368,500
70,73,70,71,78,362,362,500
74,77,78,70,70,369,369,500
77,76,71,76,74,374,374,500
73,77,78,71,71,370,370,500
77,75,72,71,70,365,365,500
78,70,70,71,70,359,359,500
76,70,71,74,78,369,369,500
70,77,75,78,73,373,373,500
75,73,76,71,70,365,365,500
72,75,76,70,73,366,366,500
70,78,75,73,77,373,373,500
76,71,77,70,70,364,364,500
76,77,76,75,77,381,381,500
74,74,78,76,78,380,380,500
74,76,75,76,73,374,374,500
77,71,74,73,73,368,368,500
72,77,76,70,71,366,366,500
77,73,72,76,74,372,372,500
72,70,70,75,77,364,364,500
70,74,71,77,78,370,370,500
70,71,74,74,78,367,367,500
78,73,74,70,73,368,368,500
70,70,74,77,71,362,362,500
78,76,78,72,70,374,374,500
73,75,77,72,77,374,374,500
76,73,73,73,73,368,368,500
78,78,76,75,72,379,379,500
76,78,70,70,72,366,366,500
75,77,78,70,78,378,378,500
74,73,77,76,75,375,375,500
76,72,78,70,75,371,371,500
78,75,75,75,73,376,376,500
78,78,71,77,78,382,382,500
71,78,75,71,77,372,372,500
78,77,78,71,70,374,374,500
70,70,75,72,72,359,359,500
70,71,72,78,71,362,362,500
74,74,72,70,70,360,360,500
77,71,76,78,73,375,375,500
72,76,77,73,73,371,371,500
71,74,73,73,74,365,365,500
75,76,78,73,77,379,379,500
71,70,70,71,78,360,360,500
73,75,71,78,78,375,375,500
72,76,77,72,71,368,368,500
76,75,73,74,71,369,369,500
70,75,73,77,74,369,369,500
78,78,78,76,76,386,386,500
78,73,72,73,77,373,373,500
71,74,72,72,77,366,366,500
72,76,70,72,72,362,362,500
78,74,74,76,77,379,379,500
73,73,77,75,75,373,373,500
73,74,73,73,76,369,369,500
74,75,77,71,77,374,374,500
75,72,77,73,78,375,375,500
77,77,74,76,76,380,380,500
75,77,73,76,77,378,378,500
75,71,70,75,77,368,368,500
77,73,70,73,76,369,369,500
70,72,71,76,71,360,360,500
73,77,72,73,77,372,372,500
78,76,73,74,75,376,376,500
73,77,78,77,77,382,382,500
77,77,70,74,71,369,369,500
70,77,71,73,75,366,366,500
75,70,73,71,75,364,364,500
70,77,75,72,77,371,371,500
72,73,75,71,76,367,367,500
72,70,73,72,75,362,362,500
77,73,74,75,75,374,374,500
78,74,77,77,77,383,383,500
70,72,76,72,76,366,366,500
77,71,78,72,77,375,375,500
77,73,70,76,76,372,372,500
78,70,75,73,73,369,369,500
76,74,71,74,73,368,368,500
77,73,72,72,73,367,367,500
74,73,78,76,74,375,375,500
77,70,76,78,71,372,372,500
73,71,78,76,70,368,368,500
71,76,76,77,76,376,376,500
73,70,72,70,77,362,362,500
74,73,74,75,72,368,368,500
78,72,74,78,73,375,375,500
76,72,73,77,76,374,374,500
70,77,75,74,70,366,366,500
70,72,76,76,73,367,367,500
76,71,76,74,76,373,373,500
71,70,74,76,75,366,366,500
70,71,78,77,75,371,371,500
73,73,71,74,70,361,361,500
71,74,74,70,73,362,362,500
70,72,74,70,78,364,364,500
72,72,78,70,72,364,364,500
75,71,72,72,77,367,367,500
75,74,72,73,73,367,367,500
71,72,76,78,76,373,373,500
76,78,74,71,75,374,374,500
70,75,70,72,75,362,362,500
72,71,73,73,71,360,360,500
73,72,73,74,72,364,364,500
71,78,70,71,74,364,364,500
74,70,70,76,76,366,366,500
76,71,77,72,74,370,370,500
74,74,76,73,78,375,375,500
75,72,75,75,78,375,375,500
77,77,70,70,72,366,366,500
74,74,73,70,75,366,366,500
75,73,74,72,70,364,364,500
71,77,74,71,78,371,371,500
70,77,78,74,70,369,369,500
70,74,71,70,77,362,362,500
70,75,76,76,78,375,375,500
75,70,73,75,75,368,368,500
77,77,77,70,73,374,374,500
70,71,71,74,75,361,361,500
74,75,73,76,74,372,372,500
78,71,77,70,72,368,368,500
78,72,76,74,71,371,371,500
73,73,78,70,70,364,364,500
76,78,76,75,76,381,381,500
75,75,74,77,78,379,379,500
76,73,78,78,78,383,383,500
70,74,70,75,74,363,363,500
71,72,70,71,76,360,360,500
77,75,72,72,73,369,369,500
74,75,75,75,70,369,369,500
71,74,71,77,71,364,364,500
78,76,71,70,70,365,365,500
76,74,78,71,73,372,372,500
74,70,77,73,75,369,369,500
70,73,73,74,73,363,363,500
71,75,74,70,73,363,363,500
77,70,70,76,77,370,370,500
76,72,72,75,75,370,370,500
76,71,77,77,77,378,378,500
70,72,74,74,72,362,362,500
72,70,71,71,71,355,355,500
71,74,76,74,75,370,370,500
70,77,76,75,76,374,374,500
76,75,78,77,75,381,381,500
72,71,75,78,71,367,367,500
78,70,77,72,77,374,374,500
74,73,76,74,70,367,367,500
77,73,71,72,78,371,371,500
72,76,73,73,76,370,370,500
73,77,72,70,74,366,366,500
73,71,76,74,72,366,366,500
73,77,72,75,77,374,374,500
74,74,77,73,71,369,369,500
78,71,78,78,70,375,375,500
77,78,74,71,72,372,372,500
75,74,77,77,77,380,380,500
73,77,78,76,73,377,377,500
77,72,73,74,73,369,369,500
70,75,74,70,75,364,364,500
75,70,70,73,74,362,362,500
78,78,76,74,78,384,384,500
71,76,78,74,70,369,369,500
76,72,72,72,75,367,367,500
71,71,77,77,76,372,372,500
73,74,76,78,74,375,375,500
77,78,78,72,78,383,383,500
75,71,78,73,76,373,373,500
76,78,74,70,73,371,371,500
72,71,75,75,72,365,365,500
71,71,75,74,77,368,368,500
70,72,77,76,70,365,365,500
71,75,76,71,76,369,369,500
71,71,76,78,76,372,372,500
78,72,76,70,70,366,366,500
71,74,77,78,75,375,375,500
73,72,75,70,76,366,366,500
72,70,74,71,74,361,361,500
71,78,72,77,71,369,369,500
73,71,76,74,71,365,365,500
75,72,76,75,73,371,371,500
76,70,74,77,75,372,372,500
76,72,76,78,75,377,377,500
75,74,73,71,74,367,367,500
72,77,72,71,73,365,365,500
73,71,78,70,71,363,363,500
76,74,73,77,74,374,374,500
76,77,75,73,70,371,371,500
77,72,74,74,71,368,368,500
74,75,73,77,71,370,370,500
72,73,71,73,76,365,365,500
76,73,76,76,72,373,373,500
75,75,74,75,77,376,376,500
71,76,73,78,71,369,369,500
75,70,75,76,74,370,370,500
73,71,75,77,71,367,367,500
73,76,77,72,73,371,371,500
70,75,72,77,73,367,367,500
71,70,75,75,71,362,362,500
76,73,78,76,74,377,377,500
71,72,76,74,77,370,370,500
71,71,74,75,78,369,369,500
74,72,72,77,71,366,366,500
77,72,78,70,70,367,367,500
78,70,73,75,74,370,370,500
70,76,73,78,78,375,375,500
71,75,70,73,72,361,361,500
70,75,73,77,78,373,373,500
72,78,73,73,72,368,368,500
78,76,71,77,70,372,372,500
77,74,77,72,75,375,375,500
77,71,74,70,78,370,370,500
73,70,78,72,70,363,363,500
70,77,70,72,72,361,361,500
74,70,73,74,76,367,367,500
76,77,78,75,77,383,383,500
75,70,70,78,77,370,370,500
75,76,71,73,70,365,365,500
76,73,76,70,71,366,366,500
78,76,77,71,75,377,377,500
70,73,73,75,73,364,364,500
71,74,72,78,71,366,366,500
70,75,78,74,78,375,375,500
77,73,78,73,76,377,377,500
74,71,76,77,71,369,369,500
75,71,71,77,76,370,370,500
72,76,73,74,70,365,365,500
77,78,77,70,77,379,379,500
75,70,75,74,74,368,368,500
70,73,72,75,78,368,368,500
72,74,75,72,77,370,370,500
71,73,77,78,70,369,369,500
72,74,77,72,72,367,367,500
74,72,71,75,72,364,364,500
72,75,70,76,78,371,371,500
78,72,74,73,75,372,372,500
71,78,78,72,78,377,377,500
75,71,73,72,77,368,368,500
70,71,76,71,70,358,358,500
71,74,78,73,78,374,374,500
71,77,76,73,78,375,375,500
71,74,77,78,73,373,373,500
70,77,74,75,74,370,370,500
73,77,75,76,75,376,376,500
73,78,75,77,75,378,378,500
71,78,73,72,78,372,372,500
70,71,72,78,76,367,367,500
70,71,78,73,73,365,365,500
75,71,77,70,76,369,369,500
70,73,78,75,78,374,374,500
72,74,71,78,72,367,367,500
75,72,77,77,70,371,371,500
77,74,77,70,71,369,369,500
75,78,75,78,73,379,379,500
71,77,73,72,76,369,369,500
77,70,76,73,70,366,366,500
73,74,71,73,74,365,365,500
72,76,74,72,75,369,369,500
71,75,76,77,74,373,373,500
78,77,74,78,70,377,377,500
72,76,72,78,76,374,374,500
70,71,74,78,71,364,364,500
71,78,75,77,75,376,376,500
71,77,78,70,77,373,373,500
70,74,76,75,73,368,368,500
75,70,73,73,73,364,364,500
75,77,75,74,71,372,372,500
73,71,72,73,71,360,360,500
72,73,75,73,74,367,367,500
71,74,71,76,75,367,367,500
70,73,75,71,75,364,364,500
77,72,76,78,70,373,373,500
76,76,73,78,76,379,379,500
72,72,73,76,78,371,371,500
75,76,70,75,73,369,369,500
72,77,78,72,75,374,374,500
72,75,77,70,73,367,367,500
76,70,76,77,78,377,377,500
74,71,74,73,77,369,369,500
74,78,78,77,78,385,385,500
77,75,71,76,76,375,375,500
73,70,70,72,70,355,355,500
72,74,78,73,75,372,372,500
77,71,71,74,72,365,365,500
78,71,70,70,71,360,360,500
75,70,72,73,74,364,364,500
71,78,76,74,72,371,371,500
76,74,73,70,78,371,371,500
77,76,71,75,71,370,370,500
72,70,71,77,76,366,366,500
73,78,70,70,72,363,363,500
70,74,75,75,71,365,365,500
75,78,74,72,74,373,373,500
72,76,70,77,70,365,365,500
70,78,70,77,78,373,373,500
77,71,77,77,78,380,380,500
78,71,71,72,78,370,370,500
73,74,73,76,78,374,374,500
72,75,73,77,76,373,373,500
78,74,78,75,71,376,376,500
70,72,73,74,71,360,360,500
77,78,74,70,76,375,375,500
70,77,74,74,75,370,370,500
73,75,72,73,71,364,364,500
75,76,74,71,71,367,367,500
75,75,77,77,76,380,380,500
74,75,74,70,72,365,365,500
75,77,70,70,78,370,370,500
74,70,71,71,77,363,363,500
74,73,73,74,75,369,369,500
77,76,76,76,72,377,377,500
75,78,76,73,73,375,375,500
77,78,76,75,77,383,383,500
72,70,72,75,73,362,362,500
73,78,73,76,78,378,378,500
72,74,78,71,71,366,366,500
73,70,75,74,77,369,369,500
78,74,70,78,78,378,378,500
74,76,75,75,74,374,374,500
71,72,78,76,72,369,369,500
70,78,77,74,72,371,371,500
71,74,71,77,77,370,370,500
70,76,70,74,72,362,362,500
77,70,70,70,77,364,364,500
78,76,74,72,77,377,377,500
75,70,74,73,70,362,362,500
77,78,73,77,72,377,377,500
75,71,74,74,78,372,372,500
74,75,75,75,75,374,374,500
72,73,78,77,72,372,372,500
76,72,77,77,75,377,377,500
75,73,72,70,72,362,362,500
76,78,75,73,70,372,372,500
78,78,70,78,71,375,375,500
70,72,77,77,71,367,367,500
78,70,77,78,73,376,376,500
76,78,72,76,76,378,378,500
78,70,74,78,78,378,378,500
70,74,75,73,76,368,368,500
74,78,76,75,78,381,381,500
70,77,78,72,76,373,373,500
70,71,78,74,73,366,366,500
72,73,73,75,74,367,367,500
71,76,73,72,73,365,365,500
74,77,73,77,73,374,374,500
76,71,75,78,72,372,372,500
78,74,76,76,78,382,382,500
73,72,71,72,70,358,358,500
70,77,76,73,75,371,371,500
70,72,73,78,74,367,367,500
74,72,73,73,73,365,365,500
75,77,71,77,76,376,376,500
74,70,76,76,76,372,372,500
70,71,70,75,73,359,359,500
74,72,71,75,71,363,363,500
78,78,76,75,72,379,379,500
72,70,75,74,76,367,367,500
78,71,77,71,70,367,367,500
72,71,74,70,76,363,363,500
78,74,70,70,70,362,362,500
71,72,71,74,73,361,361,500
77,78,77,70,71,373,373,500
78,77,74,74,75,378,378,500
73,75,77,72,73,370,370,500
75,70,71,73,76,365,365,500
71,76,71,71,77,366,366,500
74,71,71,76,76,368,368,500
76,78,70,76,74,374,374,500
75,76,71,73,70,365,365,500
77,70,73,70,71,361,361,500
75,70,74,71,77,367,367,500
74,72,78,70,77,371,371,500
74,73,74,74,71,366,366,500
76,75,78,73,74,376,376,500
75,76,76,70,73,370,370,500
71,78,74,70,77,370,370,500
72,70,75,77,70,364,364,500
72,75,72,74,74,367,367,500
74,74,77,73,73,371,371,500
74,77,75,76,70,372,372,500
75,77,73,77,74,376,376,500
74,78,72,71,73,368,368,500
70,73,71,71,76,361,361,500
76,73,78,76,75,378,378,500
70,76,73,76,73,368,368,500
71,74,75,72,77,369,369,500
72,75,75,73,72,367,367,500
77,78,72,74,74,375,375,500
74,77,73,70,72,366,366,500
76,73,77,71,76,373,373,500
72,73,74,76,72,367,367,500
77,72,75,74,76,374,374,500
71,71,71,74,72,359,359,500
73,75,77,74,74,373,373,500
74,78,73,74,74,373,373,500
78,77,78,78,70,381,381,500
74,70,74,72,75,365,365,500
72,74,73,71,72,362,362,500
71,74,76,77,78,376,376,500
77,71,72,71,70,361,361,500
74,71,78,76,77,376,376,500
71,72,78,78,74,373,373,500
72,73,71,72,77,365,365,500
70,70,74,78,73,365,365,500
78,73,75,70,75,371,371,500
75,71,71,71,78,366,366,500
72,75,72,73,70,362,362,500
74,72,77,77,78,378,378,500
71,77,71,78,78,375,375,500
74,70,72,76,77,369,369,500
78,76,77,70,73,374,374,500
73,78,74,75,77,377,377,500
77,74,74,78,76,379,379,500
76,78,74,72,73,373,373,500
77,70,78,75,76,376,376,500
74,73,74,75,76,372,372,500
72,76,77,71,76,372,372,500
76,75,70,72,74,367,367,500
70,78,74,74,70,366,366,500
74,72,70,71,73,360,360,500
71,73,73,75,76,368,368,500
78,77,71,72,75,373,373,500
74,78,78,75,78,383,383,500
76,71,74,78,77,376,376,500
75,77,76,78,73,379,379,500
72,77,75,70,78,372,372,500
71,70,75,76,76,368,368,500
73,73,76,72,75,369,369,500
71,70,78,78,71,368,368,500
75,77,75,78,78,383,383,500
73,78,77,75,78,381,381,500
74,74,70,75,77,370,370,500
72,73,70,74,73,362,362,500
77,73,70,71,71,362,362,500
71,77,77,70,77,372,372,500
72,77,76,78,76,379,379,500
77,70,74,70,72,363,363,500
75,77,77,73,73,375,375,500
71,72,77,75,72,367,367,500
70,74,76,77,72,369,369,500
72,76,73,74,78,373,373,500
78,77,78,75,77,385,385,500
74,74,75,74,77,374,374,500
72,74,71,72,75,364,364,500
73,74,77,70,71,365,365,500
75,71,73,72,70,361,361,500
78,70,74,70,71,363,363,500
75,78,78,74,78,383,383,500
77,78,70,75,70,370,370,500
77,78,77,71,76,379,379,500
73,72,72,72,78,367,367,500
78,78,71,77,71,375,375,500
76,76,78,73,75,378,378,500
70,75,78,73,77,373,373,500
73,71,72,74,71,361,361,500
72,72,71,78,73,366,366,500
78,76,74,70,71,369,369,500
71,72,74,78,76,371,371,500
76,70,74,70,77,367,367,500
73,71,70,76,73,363,363,500
73,77,75,70,76,371,371,500
70,71,75,72,71,359,359,500
71,77,74,71,71,364,364,500
75,76,76,77,72,376,376,500
76,76,77,71,74,374,374,500
70,72,74,71,70,357,357,500
75,74,77,74,74,374,374,500
73,74,74,72,73,366,366,500
78,70,76,71,70,365,365,500
78,70,75,78,77,378,378,500
78,74,76,72,76,376,376,500
70,73,71,70,70,354,354,500
71,70,75,74,70,360,360,500
72,74,72,74,76,368,368,500
73,71,74,74,73,365,365,500
71,76,78,78,70,373,373,500
78,72,77,71,72,370,370,500
76,78,78,74,76,382,382,500
76,75,71,76,77,375,375,500
78,74,76,72,72,372,372,500
75,75,70,77,76,373,373,500
76,78,74,77,78,383,383,500
76,74,78,76,76,380,380,500
75,74,74,74,73,370,370,500
78,77,74,76,78,383,383,500
73,72,76,73,77,371,371,500
73,74,77,75,76,375,375,500
75,73,78,71,77,374,374,500
76,73,76,71,77,373,373,500
70,72,71,74,75,362,362,500
70,74,71,76,78,369,369,500
76,76,78,71,75,376,376,500
72,72,78,70,75,367,367,500
76,76,77,77,78,384,384,500
71,76,70,72,73,362,362,500
75,76,76,74,77,378,378,500
76,73,76,77,78,380,380,500
71,72,71,77,74,365,365,500
70,72,75,76,70,363,363,500
73,78,75,70,77,373,373,500
75,73,74,78,78,378,378,500
78,77,75,78,75,383,383,500
73,75,75,75,70,368,368,500
71,70,76,72,75,364,364,500
72,74,72,74,74,366,366,500
78,70,72,75,74,369,369,500
70,78,74,78,74,374,374,500
70,73,73,71,78,365,365,500
74,74,77,78,71,374,374,500
72,72,72,76,74,366,366,500
71,78,78,77,75,379,379,500
73,70,71,70,76,360,360,500
70,75,78,70,78,371,371,500
73,73,77,72,72,367,367,500
74,75,75,72,71,367,367,500
77,71,70,73,75,366,366,500
77,77,74,71,73,372,372,500
74,73,76,70,77,370,370,500
72,73,77,75,74,371,371,500
74,74,78,72,76,374,374,500
76,77,78,74,78,383,383,500
76,77,74,78,74,379,379,500
77,74,71,76,70,368,368,500
72,75,74,70,73,364,364,500
73,70,76,75,75,369,369,500
72,70,77,71,77,367,367,500
74,73,74,73,75,369,369,500
77,77,70,74,71,369,369,500
78,70,78,72,77,375,375,500
76,78,78,74,73,379,379,500
70,71,75,72,70,358,358,500
70,70,77,76,77,370,370,500
73,72,76,71,71,363,363,500
76,74,76,72,76,374,374,500
71,75,78,70,71,365,365,500
72,75,72,74,76,369,369,500
70,78,75,73,78,374,374,500
76,72,75,71,72,366,366,500
77,70,78,78,76,379,379,500
71,71,74,77,75,368,368,500
70,75,72,74,76,367,367,500
70,75,73,74,73,365,365,500
73,73,72,78,76,372,372,500
77,70,76,77,72,372,372,500
70,71,72,70,77,360,360,500
70,75,71,78,77,371,371,500
75,77,74,76,70,372,372,500
70,73,72,72,71,358,358,500
76,75,77,78,73,379,379,500
77,73,76,71,78,375,375,500
78,75,72,70,74,369,369,500
75,71,72,73,76,367,367,500
70,77,72,78,77,374,374,500
73,77,71,78,70,369,369,500
74,72,73,76,76,371,371,500
73,71,77,72,74,367,367,500
72,72,70,78,71,363,363,500
74,73,78,74,75,374,374,500
71,76,72,71,78,368,368,500
74,71,75,78,78,376,376,500
76,71,78,72,75,372,372,500
72,74,70,77,73,366,366,500
70,74,70,72,70,356,356,500
74,78,72,71,74,369,369,500
75,70,70,73,78,366,366,500
74,74,72,78,76,374,374,500
71,74,72,78,75,370,370,500
72,73,77,70,73,365,365,500
73,75,71,75,70,364,364,500
70,72,71,78,77,368,368,500
71,71,75,76,75,368,368,500
72,74,70,76,72,364,364,500
71,78,77,77,71,374,374,500
76,71,71,72,78,368,368,500
70,71,71,75,73,360,360,500
74,76,71,75,75,371,371,500
77,78,76,77,77,385,385,500
77,76,75,72,78,378,378,500
72,76,77,77,70,372,372,500
76,74,70,78,78,376,376,500
73,76,71,73,70,363,363,500
71,74,72,72,77,366,366,500
76,77,72,71,71,367,367,500
73,77,74,77,77,378,378,500
73,73,73,72,71,362,362,500
72,75,73,71,78,369,369,500
74,73,75,77,74,373,373,500
78,76,77,78,76,385,385,500
71,71,76,72,74,364,364,500
73,78,71,76,71,369,369,500
74,76,72,72,72,366,366,500
78,76,76,74,77,381,381,500
75,75,70,73,75,368,368,500
75,74,76,73,77,375,375,500
75,73,75,75,74,372,372,500
75,73,77,78,76,379,379,500
77,75,74,73,78,377,377,500
70,78,71,76,73,368,368,500
78,71,71,75,76,371,371,500
70,77,71,73,76,367,367,500
77,75,75,75,70,372,372,500
74,75,71,73,70,363,363,500
78,78,75,73,71,375,375,500
76,70,77,74,71,368,368,500
72,72,74,74,77,369,369,500
74,74,78,74,75,375,375,500
75,76,75,74,77,377,377,500
72,73,70,78,71,364,364,500
74,75,76,78,78,381,381,500
73,71,77,77,75,373,373,500
73,75,76,70,73,367,367,500
73,76,77,72,75,373,373,500
78,77,70,70,76,371,371,500
71,74,72,76,72,365,365,500
72,70,73,71,75,361,361,500
78,74,76,72,73,373,373,500
71,78,75,70,75,369,369,500
77,78,71,73,76,375,375,500
73,72,71,78,73,367,367,500
74,70,71,72,78,365,365,500
75,74,76,74,73,372,372,500
74,76,73,70,73,366,366,500
76,76,74,72,77,375,375,500
72,77,78,78,70,375,375,500
70,71,77,77,73,368,368,500
72,78,77,74,78,379,379,500
71,78,74,74,76,373,373,500
72,71,71,71,71,356,356,500
76,70,70,73,78,367,367,500
74,78,75,70,74,371,371,500
72,73,78,74,70,367,367,500
73,77,73,72,74,369,369,500
72,77,70,70,71,360,360,500
74,73,71,72,76,366,366,500
72,74,71,77,72,366,366,500
73,72,70,73,75,363,363,500
71,78,76,74,76,375,375,500
78,73,78,78,73,380,380,500
77,72,78,73,72,372,372,500
75,72,77,78,76,378,378,500
77,78,76,77,78,386,386,500
72,70,73,71,71,357,357,500
78,77,76,75,70,376,376,500
76,72,76,70,71,365,365,500
73,72,78,71,78,372,372,500
73,72,71,75,75,366,366,500
72,77,73,77,75,374,374,500
74,70,75,78,74,371,371,500
75,70,77,73,77,372,372,500
77,76,77,77,71,378,378,500
76,78,75,70,76,375,375,500
70,72,75,70,73,360,360,500
76,73,70,71,75,365,365,500
71,74,74,70,72,361,361,500
75,77,75,78,71,376,376,500
73,74,78,73,71,369,369,500
71,70,74,78,72,365,365,500
77,71,73,71,75,367,367,500
78,78,73,78,78,385,385,500
77,77,75,78,73,380,380,500
73,73,78,70,77,371,371,500
71,71,75,77,71,365,365,500
77,76,78,70,71,372,372,500
77,70,78,71,72,368,368,500
73,73,71,74,74,365,365,500
77,77,76,71,74,375,375,500
75,71,71,76,78,371,371,500
78,72,74,74,78,376,376,500
75,78,78,71,71,373,373,500
76,71,78,71,74,370,370,500
71,75,76,77,76,375,375,500
75,75,71,71,72,364,364,500
73,74,78,72,73,370,370,500
78,73,75,71,77,374,374,500
70,72,76,72,75,365,365,500
74,72,72,74,77,369,369,500
70,74,75,76,70,365,365,500
76,70,73,74,73,366,366,500
78,71,70,74,78,371,371,500
71,73,74,73,77,368,368,500
70,74,74,76,70,364,364,500
71,71,71,77,74,364,364,500
72,74,76,74,77,373,373,500
74,75,74,70,74,367,367,500
72,78,73,75,74,372,372,500
73,76,77,77,74,377,377,500
78,72,75,78,77,380,380,500
70,73,75,70,70,358,358,500
72,77,71,77,77,374,374,500
78,70,72,72,74,366,366,500
75,73,77,73,77,375,375,500
70,75,73,71,73,362,362,500
70,78,71,74,73,366,366,500
75,74,76,75,77,377,377,500
75,74,74,77,76,376,376,500
77,75,77,76,75,380,380,500
76,72,73,70,77,368,368,500
73,71,71,71,78,364,364,500
73,73,78,75,72,371,371,500
76,72,76,73,77,374,374,500
76,77,71,70,71,365,365,500
72,70,76,76,73,367,367,500
73,73,73,77,73,369,369,500
70,70,71,73,73,357,357,500
75,72,72,77,76,372,372,500
70,78,70,71,72,361,361,500
75,75,70,77,72,369,369,500
76,70,77,74,76,373,373,500
76,73,75,72,76,372,372,500
70,73,71,73,76,363,363,500
71,72,73,74,74,364,364,500
77,74,70,71,77,369,369,500
78,76,74,73,71,372,372,500
78,70,73,72,72,365,365,500
70,70,71,70,72,353,353,500
74,74,71,77,71,367,367,500
71,73,78,73,71,366,366,500
70,71,76,78,74,369,369,500
72,77,74,77,72,372,372,500
76,73,70,78,70,367,367,500
72,72,77,74,73,368,368,500
72,73,76,72,70,363,363,500
71,70,74,74,73,362,362,500
74,78,70,77,76,375,375,500
70,78,75,74,72,369,369,500
72,77,73,70,74,366,366,500
71,72,77,77,75,372,372,500
78,74,70,77,73,372,372,500
72,71,74,77,74,368,368,500
72,78,78,75,75,378,378,500
76,78,73,76,78,381,381,500
73,71,76,75,78,373,373,500
73,78,74,73,70,368,368,500
77,75,76,74,70,372,372,500
77,78,70,72,74,371,371,500
72,71,71,78,77,369,369,500
70,73,75,76,71,365,365,500
74,72,72,74,76,368,368,500
76,72,71,78,74,371,371,500
72,78,77,75,76,378,378,500
76,74,70,70,76,366,366,500
73,77,78,74,76,378,378,500
77,77,76,73,71,374,374,500
77,71,72,76,75,371,371,500
72,70,78,73,70,363,363,500
75,75,71,74,71,366,366,500
74,70,71,77,74,366,366,500
74,76,76,73,75,374,374,500
77,72,76,70,77,372,372,500
71,71,72,72,73,359,359,500
74,78,77,72,74,375,375,500
74,74,75,75,72,370,370,500
78,73,72,73,77,373,373,500
76,74,72,73,76,371,371,500
75,70,78,71,75,369,369,500
75,78,73,77,72,375,375,500
72,73,76,75,78,374,374,500
78,71,70,70,73,362,362,500
73,72,72,70,78,365,365,500
70,75,73,77,72,367,367,500
75,71,76,73,76,371,371,500
75,72,72,78,74,371,371,500
74,78,75,70,77,374,374,500
71,70,70,77,72,360,360,500
70,73,70,77,73,363,363,500
77,73,73,74,70,367,367,500
73,72,74,75,74,368,368,500
78,73,78,72,77,378,378,500
78,76,70,74,75,373,373,500
76,73,74,74,72,369,369,500
73,71,70,73,78,365,365,500
70,71,76,78,76,371,371,500
75,75,78,70,78,376,376,500
75,73,74,70,75,367,367,500
71,73,72,71,71,358,358,500
76,73,77,77,74,377,377,500
72,70,73,77,73,365,365,500
73,70,77,70,71,361,361,500
70,75,73,78,71,367,367,500
72,72,73,77,73,367,367,500
78,74,77,78,70,377,377,500
71,78,72,72,77,370,370,500
76,75,72,74,70,367,367,500
78,76,71,71,71,367,367,500
75,71,76,75,72,369,369,500
72,75,71,74,70,362,362,500
73,74,75,78,76,376,376,500
76,77,74,75,74,376,376,500
74,78,72,71,71,366,366,500
73,70,73,71,71,358,358,500
70,70,75,72,73,360,360,500
74,70,77,73,78,372,372,500
74,76,76,76,78,380,380,500
76,74,70,71,70,361,361,500
71,76,74,75,77,373,373,500
71,77,72,70,73,363,363,500
76,76,75,76,76,379,379,500
75,70,75,76,70,366,366,500
78,73,76,75,75,377,377,500
75,78,73,78,70,374,374,500
77,73,72,71,74,367,367,500
74,76,76,70,73,369,369,500
78,72,72,76,75,373,373,500
72,70,78,72,73,365,365,500
70,78,71,74,73,366,366,500
77,76,75,72,71,371,371,500
77,72,77,76,71,373,373,500
78,73,72,75,74,372,372,500
70,70,72,70,73,355,355,500
78,78,78,70,76,380,380,500
77,78,78,73,76,382,382,500
70,74,71,72,71,358,358,500
78,74,77,77,74,380,380,500
76,71,71,70,76,364,364,500
74,70,78,77,72,371,371,500
70,75,71,70,73,359,359,500
74,78,72,77,72,373,373,500
75,77,74,70,73,369,369,500
73,78,71,73,73,368,368,500
71,75,78,70,78,372,372,500
71,76,75,77,70,369,369,500
74,75,78,72,77,376,376,500
72,75,72,73,78,370,370,500
73,78,78,72,78,379,379,500
71,72,76,71,78,368,368,500
71,76,78,77,76,378,378,500
76,78,76,78,76,384,384,500
72,70,77,75,73,367,367,500
70,76,71,70,72,359,359,500
76,77,72,75,74,374,374,500
77,73,73,73,78,374,374,500
73,76,76,72,78,375,375,500
74,77,77,76,77,381,381,500
71,74,76,70,77,368,368,500
78,73,75,72,78,376,376,500
72,71,75,77,71,366,366,500
77,71,70,74,76,368,368,500
77,77,76,70,76,376,376,500
77,77,76,75,77,382,382,500
77,77,78,75,76,383,383,500
71,76,78,71,76,372,372,500
78,72,71,78,70,369,369,500
71,76,72,72,73,364,364,500
77,72,77,74,76,376,376,500
71,70,70,70,76,357,357,500
74,77,71,77,76,375,375,500
70,72,78,78,78,376,376,500
73,71,76,71,74,365,365,500
78,72,78,73,74,375,375,500
72,73,75,75,71,366,366,500
70,71,78,72,77,368,368,500
74,72,76,76,70,368,368,500
73,78,76,71,71,369,369,500
78,77,76,73,72,376,376,500
76,72,70,71,75,364,364,500
73,70,77,73,76,369,369,500
75,74,72,77,70,368,368,500
76,74,78,74,70,372,372,500
73,71,72,78,70,364,364,500
75,70,77,73,75,370,370,500
77,77,76,78,77,385,385,500
71,70,74,77,78,370,370,500
77,73,78,75,71,374,374,500
75,70,78,78,72,373,373,500
76,75,77,75,77,380,380,500
74,73,78,77,75,377,377,500
71,73,74,72,72,362,362,500
70,75,72,77,78,372,372,500
76,72,74,70,74,366,366,500
75,73,75,75,74,372,372,500
75,78,71,75,75,374,374,500
72,76,77,77,71,373,373,500
71,75,73,71,71,361,361,500
71,75,78,76,77,377,377,500
74,73,71,77,74,369,369,500
72,75,75,77,75,374,374,500
73,72,76,71,75,367,367,500
76,74,72,75,77,374,374,500
72,78,70,73,76,369,369,500
77,74,76,78,76,381,381,500
76,77,74,77,70,374,374,500
70,76,74,75,75,370,370,500
74,78,72,72,72,368,368,500
73,73,75,73,72,366,366,500
71,72,76,77,72,368,368,500
76,75,71,72,78,372,372,500
73,73,75,72,75,368,368,500
71,76,77,71,70,365,365,500
74,72,78,73,75,372,372,500
71,71,71,72,70,355,355,500
77,72,70,76,77,372,372,500
76,74,73,78,77,378,378,500
70,73,75,75,78,371,371,500
77,72,73,73,74,369,369,500
73,70,74,76,78,371,371,500
72,75,70,77,73,367,367,500
73,77,78,73,77,378,378,500
77,77,75,78,77,384,384,500
73,71,74,77,72,367,367,500
76,72,74,72,77,371,371,500
74,78,75,75,78,380,380,500
76,72,76,75,72,371,371,500
78,75,73,70,75,371,371,500
72,74,78,75,71,370,370,500
77,71,75,78,75,376,376,500
75,75,71,72,77,370,370,500
76,72,77,74,74,373,373,500
77,77,73,71,76,374,374,500
74,71,74,76,71,366,366,500
72,72,71,73,72,360,360,500
72,76,75,70,70,363,363,500
74,74,70,77,77,372,372,500
74,70,72,76,72,364,364,500
72,74,75,72,71,364,364,500
78,71,74,76,77,376,376,500
74,73,78,72,71,368,368,500
75,73,73,74,71,366,366,500
73,77,74,78,73,375,375,500
75,70,71,77,78,371,371,500
74,78,77,77,76,382,382,500
73,75,75,76,73,372,372,500
74,77,72,77,75,375,375,500
77,76,73,70,76,372,372,500
73,78,70,76,72,369,369,500
70,74,72,72,73,361,361,500
74,73,76,71,74,368,368,500
77,77,73,71,70,368,368,500
74,74,77,75,70,370,370,500
71,76,78,74,74,373,373,500
75,75,77,73,70,370,370,500
78,70,74,76,76,374,374,500
73,70,70,76,72,361,361,500
76,70,70,72,70,358,358,500
70,71,78,76,74,369,369,500
74,71,76,77,72,370,370,500
70,78,77,74,70,369,369,500
76,73,75,73,75,372,372,500
71,72,72,77,78,370,370,500
74,77,74,77,77,379,379,500
78,74,74,71,77,374,374,500
71,78,74,75,71,369,369,500
70,73,77,76,75,371,371,500
73,71,73,75,70,362,362,500
71,70,76,71,76,364,364,500
74,70,76,72,77,369,369,500
74,70,75,75,74,368,368,500
75,70,75,77,78,375,375,500
76,73,71,72,76,368,368,500
70,71,77,74,71,363,363,500
70,70,70,70,73,353,353,500
78,71,73,74,76,372,372,500
73,76,70,74,76,369,369,500
70,77,72,77,72,368,368,500
73,78,78,71,73,373,373,500
78,74,72,71,71,366,366,500
76,76,74,73,73,372,372,500
72,71,76,78,74,371,371,500
70,73,75,75,71,364,364,500
75,78,72,71,70,366,366,500
76,74,75,73,72,370,370,500
73,78,76,77,78,382,382,500
75,73,74,76,70,368,368,500
73,73,70,77,75,368,368,500
73,76,77,75,75,376,376,500
70,73,78,76,75,372,372,500
71,78,70,72,78,369,369,500
75,73,71,72,78,369,369,500
77,73,74,72,71,367,367,500
77,74,76,72,77,376,376,500
74,78,71,73,71,367,367,500
71,74,71,73,77,366,366,500
75,78,74,74,72,373,373,500
74,70,70,72,75,361,361,500
76,72,74,77,74,373,373,500
70,76,71,76,70,363,363,500
73,73,76,72,73,367,367,500
70,75,74,73,72,364,364,500
77,73,72,71,75,368,368,500
76,76,74,71,75,372,372,500
77,77,70,77,75,376,376,500
73,73,72,71,71,360,360,500
70,78,73,71,74,366,366,500
70,71,76,73,78,368,368,500
75,70,71,73,75,364,364,500
72,75,77,71,76,371,371,500
78,78,77,78,78,389,389,500
70,75,73,72,74,364,364,500
78,76,71,76,78,379,379,500
70,77,78,78,73,376,376,500
72,74,77,78,71,372,372,500
76,74,70,76,74,370,370,500
78,71,71,72,73,365,365,500
72,74,74,77,78,375,375,500
78,72,72,70,71,363,363,500
72,77,78,76,78,381,381,500
78,75,75,76,70,374,374,500
77,72,72,78,78,377,377,500
74,71,76,78,75,374,374,500
75,71,74,74,70,364,364,500
71,74,71,71,70,357,357,500
74,78,71,72,77,372,372,500
76,78,75,72,77,378,378,500
78,73,70,77,76,374,374,500
76,70,74,76,77,373,373,500
72,74,73,75,76,370,370,500
70,76,74,73,78,371,371,500
70,70,76,78,77,371,371,500
71,77,78,72,70,368,368,500
71,73,76,78,70,368,368,500
74,76,70,71,70,361,361,500
74,78,71,71,75,369,369,500
72,72,74,73,78,369,369,500
77,74,73,70,70,364,364,500
70,77,70,75,74,366,366,500
78,72,76,75,70,371,371,500
77,76,74,70,72,369,369,500
75,74,77,77,71,374,374,500
73,71,74,77,77,372,372,500
71,70,73,75,74,363,363,500
77,74,78,70,70,369,369,500
72,74,77,76,73,372,372,500
78,72,72,77,76,375,375,500
78,70,73,72,77,370,370,500
70,75,74,77,75,371,371,500
71,78,78,75,74,376,376,500
77,72,70,76,77,372,372,500
78,75,78,75,72,378,378,500
75,77,72,75,73,372,372,500
73,73,77,73,76,372,372,500
76,77,75,70,76,374,374,500
77,71,75,77,72,372,372,500
75,76,73,72,70,366,366,500
75,77,75,75,77,379,379,500
74,73,75,76,78,376,376,500
71,78,73,70,78,370,370,500
71,75,77,72,74,369,369,500
75,78,76,71,75,375,375,500
77,78,75,73,73,376,376,500
73,78,75,78,70,374,374,500
78,73,78,72,76,377,377,500
74,73,71,76,74,368,368,500
72,70,70,71,73,356,356,500
76,73,74,77,72,372,372,500
78,78,78,72,78,384,384,500
71,74,70,72,73,360,360,500
77,71,73,76,78,375,375,500
70,72,76,70,76,364,364,500
76,70,71,74,73,364,364,500
78,73,71,72,76,370,370,500
70,74,78,77,72,371,371,500
76,78,70,77,71,372,372,500
75,73,78,70,77,373,373,500
71,75,72,72,72,362,362,500
76,70,71,75,72,364,364,500
76,71,71,73,71,362,362,500
74,78,72,78,70,372,372,500
76,75,73,77,74,375,375,500
78,71,76,74,75,374,374,500
72,70,74,75,77,368,368,500
78,77,72,76,77,380,380,500
74,72,71,74,74,365,365,500
70,72,74,70,70,356,356,500
71,72,74,72,73,362,362,500
72,78,71,72,76,369,369,500
76,78,77,75,72,378,378,500
77,74,77,75,71,374,374,500
75,73,78,78,76,380,380,500
70,78,72,75,73,368,368,500
74,73,77,77,72,373,373,500
77,76,72,77,72,374,374,500
75,74,75,77,76,377,377,500
73,75,73,72,72,365,365,500
70,74,76,70,72,362,362,500
70,71,75,78,71,365,365,500
70,78,77,75,74,374,374,500
75,76,71,75,73,370,370,500
76,70,70,77,75,368,368,500
70,78,77,74,74,373,373,500
72,77,75,76,75,375,375,500
70,77,78,76,77,378,378,500
72,71,70,77,74,364,364,500
76,71,78,76,78,379,379,500
76,74,77,76,77,380,380,500
77,70,70,74,77,368,368,500
73,71,72,77,72,365,365,500
71,71,72,71,75,360,360,500
72,72,76,78,70,368,368,500
72,76,78,72,75,373,373,500
71,78,72,75,77,373,373,500
72,75,77,73,71,368,368,500
77,75,70,73,78,373,373,500
71,75,71,77,78,372,372,500
77,74,75,72,75,373,373,500
76,70,77,77,70,370,370,500
75,71,70,71,75,362,362,500
73,70,70,77,77,367,367,500
73,77,72,73,74,369,369,500
76,70,70,72,75,363,363,500
76,78,77,71,76,378,378,500
71,74,77,74,72,368,368,500
71,70,77,76,73,367,367,500
71,72,76,72,76,367,367,500
77,76,72,77,70,372,372,500
71,77,75,70,73,366,366,500
73,71,77,75,74,370,370,500
77,77,75,71,75,375,375,500
70,73,77,70,75,365,365,500
72,72,70,70,77,361,361,500
76,74,74,71,70,365,365,500
72,77,72,75,76,372,372,500
76,71,72,77,78,374,374,500
72,75,77,74,74,372,372,500
75,70,74,77,73,369,369,500
70,70,77,75,74,366,366,500
78,77,77,75,70,377,377,500
78,73,70,71,77,369,369,500
76,77,72,76,77,378,378,500
74,72,72,73,72,363,363,500
71,76,74,78,72,371,371,500
77,70,70,71,72,360,360,500
73,75,75,78,76,377,377,500
76,77,70,74,77,374,374,500
74,77,70,74,77,372,372,500
75,77,70,76,75,373,373,500
77,70,76,70,74,367,367,500
77,74,71,70,73,365,365,500
71,78,70,75,71,365,365,500
72,75,77,77,76,377,377,500
73,70,75,77,76,371,371,500
70,73,71,77,74,365,365,500
75,73,71,71,73,363,363,500
76,74,77,76,71,374,374,500
73,74,73,70,70,360,360,500
75,74,72,70,72,363,363,500
75,76,71,76,73,371,371,500
73,73,74,70,74,364,364,500
71,77,73,74,75,370,370,500
76,72,78,71,73,370,370,500
76,71,75,77,70,369,369,500
70,78,76,73,77,374,374,500
72,72,78,75,78,375,375,500
76,73,76,75,71,371,371,500
78,76,78,70,77,379,379,500
76,78,76,70,77,377,377,500
73,71,77,75,76,372,372,500
70,70,75,71,74,360,360,500
76,73,78,71,75,373,373,500
74,78,71,74,78,375,375,500
75,73,70,75,76,369,369,500
74,70,74,77,71,366,366,500
73,70,78,76,73,370,370,500
78,74,75,72,77,376,376,500
75,74,76,72,75,372,372,500
73,78,74,75,71,371,371,500
73,75,70,77,74,369,369,500
73,77,73,77,76,376,376,500
73,75,71,72,71,362,362,500
77,74,72,76,77,376,376,500
71,75,77,78,71,372,372,500
78,74,77,71,78,378,378,500
76,77,73,71,75,372,372,500
75,76,71,77,74,373,373,500
74,77,71,73,73,368,368,500
77,71,77,74,73,372,372,500
70,74,76,70,76,366,366,500
70,73,77,76,76,372,372,500
75,75,77,73,76,376,376,500
75,75,74,74,72,370,370,500
76,78,73,73,71,371,371,500
75,78,77,71,76,377,377,500
77,77,70,70,76,370,370,500
72,77,77,71,77,374,374,500
78,74,78,71,71,372,372,500
74,71,77,70,71,363,363,500
74,70,76,76,73,369,369,500
75,73,74,75,75,372,372,500
70,72,77,71,74,364,364,500
70,75,72,74,71,362,362,500
71,78,78,74,71,372,372,500
75,74,74,73,75,371,371,500
73,70,73,72,75,363,363,500
72,70,78,71,72,363,363,500
70,70,71,72,70,353,353,500
74,70,75,71,74,364,364,500
70,70,72,70,70,352,352,500
71,73,72,76,72,364,364,500
70,75,76,73,78,372,372,500
73,76,78,71,77,375,375,500
76,75,74,78,76,379,379,500
78,72,78,70,70,368,368,500
73,70,74,78,73,368,368,500
74,78,70,77,78,377,377,500
77,76,71,75,75,374,374,500
70,76,73,77,76,372,372,500
70,74,75,75,70,364,364,500
73,74,78,75,73,373,373,500
77,75,76,71,77,376,376,500
76,73,77,75,77,378,378,500
74,70,73,71,72,360,360,500
73,73,70,72,74,362,362,500
76,72,72,76,73,369,369,500
77,73,73,76,71,370,370,500
73,70,78,75,74,370,370,500
78,70,74,76,74,372,372,500
77,76,72,72,74,371,371,500
71,75,74,77,71,368,368,500
77,73,78,78,70,376,376,500
72,78,73,75,71,369,369,500
77,71,76,76,73,373,373,500
72,70,75,73,70,360,360,500
73,77,70,71,75,366,366,500
77,71,70,73,73,364,364,500
72,73,75,78,78,376,376,500
75,71,75,71,75,367,367,500
78,73,72,77,70,370,370,500
73,72,71,76,70,362,362,500
78,70,73,71,77,369,369,500
75,74,78,72,74,373,373,500
77,71,70,73,71,362,362,500
78,77,72,78,74,379,379,500
78,73,77,77,72,377,377,500
76,76,73,75,70,370,370,500
76,75,74,78,71,374,374,500
73,71,76,75,78,373,373,500
78,71,73,73,72,367,367,500
75,74,74,78,75,376,376,500
77,76,75,74,72,374,374,500
76,77,71,74,71,369,369,500
78,78,78,76,77,387,387,500
75,75,73,73,76,372,372,500
75,78,72,76,76,377,377,500
77,72,77,75,71,372,372,500
76,73,78,75,72,374,374,500
71,75,77,78,70,371,371,500
78,78,73,78,77,384,384,500
78,71,71,74,78,372,372,500
76,76,76,70,71,369,369,500
75,76,74,75,73,373,373,500
73,74,77,70,71,365,365,500
70,77,74,76,71,368,368,500
75,73,76,77,73,374,374,500
71,70,74,76,73,364,364,500
72,70,72,78,70,362,362,500
74,78,70,73,70,365,365,500
77,70,73,76,71,367,367,500
75,78,76,72,72,373,373,500
74,70,78,72,73,367,367,500
73,76,76,74,77,376,376,500
72,73,76,73,76,370,370,500
75,75,78,70,73,371,371,500
74,74,76,72,73,369,369,500
73,74,71,74,72,364,364,500
76,77,73,71,78,375,375,500
74,71,72,76,71,364,364,500
70,70,78,71,71,360,360,500
73,78,75,70,78,374,374,500
78,70,71,77,78,374,374,500
76,78,71,74,77,376,376,500
73,71,74,78,74,370,370,500
72,77,71,76,70,366,366,500
75,70,70,70,76,361,361,500
72,72,71,73,74,362,362,500
71,74,74,75,71,365,365,500
74,78,75,74,72,373,373,500
70,76,75,77,74,372,372,500
78,70,73,72,73,366,366,500
70,78,77,76,75,376,376,500
70,75,71,73,73,362,362,500
75,71,72,73,74,365,365,500
71,77,74,72,72,366,366,500
70,71,75,77,71,364,364,500
72,75,74,76,70,367,367,500
77,73,73,76,75,374,374,500
71,75,70,78,71,365,365,500
72,71,74,77,76,370,370,500
70,78,77,78,71,374,374,500
76,71,77,76,76,376,376,500
73,78,77,72,75,375,375,500
78,72,78,74,75,377,377,500
71,76,70,72,77,366,366,500
76,71,73,78,71,369,369,500
77,73,71,71,70,362,362,500
76,73,74,76,77,376,376,500
75,72,71,70,75,363,363,500
74,71,71,74,76,366,366,500
74,70,73,71,75,363,363,500
71,71,71,74,70,357,357,500
73,70,78,78,74,373,373,500
76,75,70,72,73,366,366,500
71,76,71,72,74,364,364,500
73,70,76,70,73,362,362,500
77,76,78,74,75,380,380,500
72,71,75,74,72,364,364,500
72,70,71,72,72,357,357,500
76,74,74,74,73,371,371,500
78,71,78,73,73,373,373,500
71,72,77,78,70,368,368,500
74,70,74,77,70,365,365,500
71,78,76,78,73,376,376,500
71,77,76,70,72,366,366,500
78,72,75,73,77,375,375,500
78,70,75,76,76,375,375,500
76,74,73,76,74,373,373,500
75,74,78,71,78,376,376,500
78,75,71,74,74,372,372,500
72,71,78,71,71,363,363,500
78,75,73,75,72,373,373,500
78,75,75,71,70,369,369,500
77,78,72,73,78,378,378,500
70,78,70,77,70,365,365,500
78,76,78,78,70,380,380,500
70,72,78,72,70,362,362,500
74,73,73,77,72,369,369,500
75,75,77,78,77,382,382,500
74,70,74,72,78,368,368,500
77,74,74,71,76,372,372,500
75,75,70,76,77,373,373,500
75,73,78,71,71,368,368,500
75,75,73,72,74,369,369,500
72,74,76,73,73,368,368,500
74,78,78,73,76,379,379,500
78,78,70,72,75,373,373,500
73,74,72,70,73,362,362,500
74,71,71,71,74,361,361,500
70,78,71,76,75,370,370,500
73,74,75,70,72,364,364,500
76,77,75,77,70,375,375,500
73,72,72,74,70,361,361,500
75,75,74,77,77,378,378,500
72,70,72,76,78,368,368,500
73,78,73,75,77,376,376,500
76,75,74,75,74,374,374,500
74,74,78,75,73,374,374,500
77,72,73,73,73,368,368,500
76,71,72,75,70,364,364,500
78,72,75,77,70,372,372,500
70,78,78,72,72,370,370,500
78,75,76,71,73,373,373,500
74,72,72,73,70,361,361,500
75,74,70,78,75,372,372,500
74,72,73,72,72,363,363,500
72,77,74,74,73,370,370,500
78,72,71,72,73,366,366,500
74,76,78,75,73,376,376,500
71,70,71,71,74,357,357,500
72,74,75,72,78,371,371,500
76,73,71,73,71,364,364,500
76,70,73,72,72,363,363,500
77,74,74,74,72,371,371,500
73,74,77,72,77,373,373,500
73,75,76,76,71,371,371,500
78,75,74,71,77,375,375,500
72,75,75,73,72,367,367,500
72,73,75,77,71,368,368,500
75,75,71,75,72,368,368,500
76,76,75,71,76,374,374,500
77,70,75,74,76,372,372,500
71,70,75,76,72,364,364,500
76,75,72,71,71,365,365,500
72,73,76,77,74,372,372,500
71,71,70,75,70,357,357,500
72,78,76,70,70,366,366,500
73,77,77,74,75,376,376,500
76,75,74,73,71,369,369,500
76,71,71,76,74,368,368,500
77,72,75,74,76,374,374,500
75,73,74,71,76,369,369,500
73,77,75,73,74,372,372,500
75,77,78,71,73,374,374,500
71,70,78,71,71,361,361,500
77,76,77,72,75,377,377,500
71,76,73,77,78,375,375,500
74,70,71,74,74,363,363,500
70,75,78,71,76,370,370,500
71,78,75,73,72,369,369,500
70,71,71,76,77,365,365,500
78,73,75,76,71,373,373,500
71,71,75,75,72,364,364,500
78,72,75,72,71,368,368,500
70,73,73,71,71,358,358,500
76,77,75,76,78,382,382,500
76,74,70,73,72,365,365,500
78,78,75,74,77,382,382,500
74,77,74,72,73,370,370,500
72,72,71,77,75,367,367,500
71,71,72,70,75,359,359,500
78,73,70,78,75,374,374,500
71,76,72,72,73,364,364,500
78,70,78,78,75,379,379,500
72,75,71,74,72,364,364,500
76,77,70,71,77,371,371,500
76,76,72,73,78,375,375,500
74,70,72,74,76,366,366,500
76,75,74,78,74,377,377,500
75,74,70,70,71,360,360,500
78,70,70,74,74,366,366,500
76,70,71,71,73,361,361,500
78,76,70,72,74,370,370,500
70,71,70,73,72,356,356,500
72,71,71,77,73,364,364,500
74,77,73,73,76,373,373,500
74,70,76,78,74,372,372,500
74,76,73,74,76,373,373,500
71,71,70,71,75,358,358,500
78,74,71,74,70,367,367,500
75,72,74,74,75,370,370,500
74,73,78,75,72,372,372,500
70,73,74,74,72,363,363,500
74,71,77,76,77,375,375,500
73,76,74,72,75,370,370,500
76,73,74,77,70,370,370,500
70,73,71,71,74,359,359,500
70,70,71,78,78,367,367,500
73,71,78,72,71,365,365,500
71,72,71,74,78,366,366,500
72,75,75,70,70,362,362,500
77,78,72,77,70,374,374,500
75,74,76,75,71,371,371,500
76,76,77,76,70,375,375,500
70,76,74,77,74,371,371,500
72,75,73,74,73,367,367,500
75,70,74,71,71,361,361,500
70,75,72,74,72,363,363,500
73,71,73,75,72,364,364,500
70,75,77,75,71,368,368,500
72,70,77,76,78,373,373,500
71,70,72,76,77,366,366,500
77,73,74,74,70,368,368,500
74,72,73,75,77,371,371,500
77,72,72,74,71,366,366,500
70,74,76,71,70,361,361,500
71,75,77,76,70,369,369,500
75,71,72,70,76,364,364,500
75,78,73,73,74,373,373,500
74,72,71,72,73,362,362,500
78,71,74,75,70,368,368,500
76,75,73,78,74,376,376,500
70,73,75,74,78,370,370,500
74,72,72,71,78,367,367,500
72,74,78,73,74,371,371,500
75,75,75,72,70,367,367,500
75,77,73,73,78,376,376,500
75,70,73,77,70,365,365,500
73,72,75,75,77,372,372,500
75,76,73,76,78,378,378,500
75,73,77,74,71,370,370,500
77,71,71,77,77,373,373,500
70,76,76,77,73,372,372,500
75,74,76,71,73,369,369,500
70,70,78,76,73,367,367,500
75,78,75,74,72,374,374,500
77,77,73,74,74,375,375,500
78,76,78,74,74,380,380,500
71,76,78,76,77,378,378,500
74,76,76,75,75,376,376,500
78,76,71,73,72,370,370,500
72,76,78,78,73,377,377,500
77,72,70,75,73,367,367,500
76,77,70,74,75,372,372,500
73,76,70,70,71,360,360,500
76,77,72,70,77,372,372,500
70,71,70,71,76,358,358,500
74,78,75,78,70,375,375,500
75,75,75,76,71,372,372,500
74,76,76,76,78,380,380,500
72,74,72,77,76,371,371,500
70,77,78,72,74,371,371,500
77,72,75,70,77,371,371,500
73,70,71,77,76,367,367,500
76,72,77,73,72,370,370,500
70,78,71,75,70,364,364,500
76,76,72,70,71,365,365,500
71,76,77,77,77,378,378,500
72,75,75,71,77,370,370,500
74,75,70,74,76,369,369,500
77,76,76,72,71,372,372,500
70,75,76,73,70,364,364,500
77,76,77,74,70,374,374,500
72,70,70,78,78,368,368,500
75,75,75,77,77,379,379,500
74,75,76,77,75,377,377,500
71,72,77,75,74,369,369,500
74,72,70,75,71,362,362,500
74,70,77,76,72,369,369,500
71,70,78,70,70,359,359,500
78,74,73,71,72,368,368,500
70,77,74,71,78,370,370,500
78,76,70,75,70,369,369,500
71,76,78,75,74,374,374,500
75,72,75,74,78,374,374,500
78,74,74,73,76,375,375,500
73,73,77,76,72,371,371,500
76,78,75,78,77,384,384,500
76,77,74,71,71,369,369,500
74,73,71,74,74,366,366,500
75,77,74,72,70,368,368,500
78,78,73,72,76,377,377,500
77,70,72,76,73,368,368,500
73,71,71,77,71,363,363,500
70,74,73,70,77,364,364,500
74,78,74,75,70,371,371,500
70,71,71,71,75,358,358,500
72,73,73,70,77,365,365,500
78,73,74,74,74,373,373,500
70,74,78,72,78,372,372,500
71,70,75,70,78,364,364,500
77,71,72,76,72,368,368,500
77,74,75,75,73,374,374,500
74,75,71,74,74,368,368,500
72,74,73,71,73,363,363,500
72,75,71,71,70,359,359,500
70,72,77,76,73,368,368,500
70,73,74,75,74,366,366,500
76,73,74,71,73,367,367,500
73,73,77,72,76,371,371,500
78,72,72,73,72,367,367,500
70,71,72,77,75,365,365,500
73,74,74,77,72,370,370,500
70,75,73,70,75,363,363,500
76,77,71,72,78,374,374,500
77,73,77,73,70,370,370,500
71,76,74,77,77,375,375,500
70,71,71,70,78,360,360,500
73,76,76,70,77,372,372,500
74,77,71,75,71,368,368,500
75,74,73,72,77,371,371,500
71,77,70,71,72,361,361,500
74,76,73,78,71,372,372,500
72,70,75,76,71,364,364,500
70,72,73,72,78,365,365,500
70,74,78,73,72,367,367,500
73,71,73,78,74,369,369,500
76,78,72,75,74,375,375,500
78,76,78,78,78,388,388,500
75,78,78,70,71,372,372,500
73,76,72,78,76,375,375,500
76,70,77,73,75,371,371,500
74,78,70,77,78,377,377,500
76,76,74,74,74,374,374,500
70,78,74,75,77,374,374,500
73,76,71,76,74,370,370,500
73,71,75,75,72,366,366,500
78,70,77,71,75,371,371,500
78,71,74,74,77,374,374,500
72,70,77,75,74,368,368,500
74,70,76,77,76,373,373,500
73,71,78,77,72,371,371,500
78,72,76,77,72,375,375,500
72,70,76,76,75,369,369,500
73,72,78,70,71,364,364,500
77,74,73,75,77,376,376,500
74,75,76,74,74,373,373,500
75,75,74,73,74,371,371,500
71,73,75,70,72,361,361,500
70,75,72,78,72,367,367,500
77,74,74,76,71,372,372,500
70,71,72,77,73,363,363,500
72,74,72,72,76,366,366,500
75,72,70,71,70,358,358,500
78,71,72,75,74,370,370,500
72,71,73,75,75,366,366,500
74,74,73,77,72,370,370,500
76,74,71,71,77,369,369,500
75,74,72,70,71,362,362,500
78,70,77,75,75,375,375,500
75,74,72,78,78,377,377,500
77,76,75,70,70,368,368,500
76,70,71,74,72,363,363,500
75,75,73,75,78,376,376,500
78,75,73,75,72,373,373,500
73,75,76,70,76,370,370,500
71,73,78,72,74,368,368,500
75,75,71,74,78,373,373,500
70,75,77,73,78,373,373,500
78,76,72,75,78,379,379,500
78,77,72,78,72,377,377,500
77,76,71,70,74,368,368,500
72,70,78,78,70,368,368,500
74,71,73,78,77,373,373,500
74,78,74,74,72,372,372,500
73,74,70,76,74,367,367,500
75,72,73,75,76,371,371,500
72,77,74,72,71,366,366,500
71,72,70,73,72,358,358,500
70,75,72,71,76,364,364,500
74,76,73,78,74,375,375,500
73,73,75,72,71,364,364,500
73,73,75,74,73,368,368,500
72,75,77,75,76,375,375,500
71,75,75,70,75,366,366,500
75,72,77,73,75,372,372,500
78,75,75,76,74,378,378,500
76,76,77,75,76,380,380,500
72,71,75,76,77,371,371,500
76,73,72,77,75,373,373,500
73,70,71,77,77,368,368,500
72,71,72,72,72,359,359,500
76,75,70,75,72,368,368,500
78,75,75,72,76,376,376,500
74,71,74,72,71,362,362,500
75,70,71,78,70,364,364,500
70,75,76,77,73,371,371,500
76,71,75,72,75,369,369,500
71,73,70,71,75,360,360,500
70,72,78,75,77,372,372,500
77,72,76,74,75,374,374,500
76,76,77,74,73,376,376,500
77,71,73,70,74,365,365,500
76,71,73,73,74,367,367,500
71,78,71,70,76,366,366,500
75,72,70,71,77,365,365,500
75,75,70,77,75,372,372,500
74,70,76,74,78,372,372,500
76,73,77,71,76,373,373,500
78,70,78,75,75,376,376,500
71,71,78,74,74,368,368,500
75,78,78,76,71,378,378,500
71,77,78,73,76,375,375,500
77,72,71,70,72,362,362,500
72,78,72,75,78,375,375,500
78,73,71,70,72,364,364,500
70,71,73,74,72,360,360,500
77,72,71,74,70,364,364,500
73,76,73,78,72,372,372,500
70,76,78,72,71,367,367,500
73,72,74,75,77,371,371,500
70,75,72,77,78,372,372,500
70,70,76,70,74,360,360,500
78,76,70,74,72,370,370,500
70,78,75,72,75,370,370,500
70,73,78,71,70,362,362,500
73,70,70,76,75,364,364,500
74,72,72,72,75,365,365,500
72,75,70,75,73,365,365,500
75,71,73,73,74,366,366,500
73,76,74,73,77,373,373,500
71,75,78,73,76,373,373,500
76,75,73,77,75,376,376,500
77,77,75,72,73,374,374,500
72,73,77,76,76,374,374,500
74,75,71,76,74,370,370,500
72,77,76,73,72,370,370,500
77,70,73,70,77,367,367,500
78,74,77,71,74,374,374,500
73,74,77,72,72,368,368,500
75,77,77,76,76,381,381,500
74,78,74,75,70,371,371,500
75,76,71,78,73,373,373,500
78,78,70,78,70,374,374,500
78,70,78,73,70,369,369,500
76,72,77,70,75,370,370,500
78,77,70,74,70,369,369,500
78,74,71,78,72,373,373,500
72,73,70,72,76,363,363,500
78,70,75,74,70,367,367,500
76,74,73,70,74,367,367,500
72,70,73,76,76,367,367,500
78,77,77,75,72,379,379,500
76,78,74,75,77,380,380,500
71,78,75,75,75,374,374,500
77,74,76,76,76,379,379,500
77,78,74,70,73,372,372,500
71,78,70,70,72,361,361,500
71,71,73,72,73,360,360,500
72,70,76,76,72,366,366,500
78,77,77,77,70,379,379,500
70,71,74,76,71,362,362,500
71,75,72,73,76,367,367,500
77,71,75,71,70,364,364,500
71,71,71,72,78,363,363,500
74,70,75,78,75,372,372,500
76,70,78,76,71,371,371,500
71,75,72,72,77,367,367,500
76,76,77,72,73,374,374,500
74,72,75,70,77,368,368,500
70,71,75,71,74,361,361,500
78,78,74,71,76,377,377,500
72,75,77,72,73,369,369,500
76,72,70,72,77,367,367,500
76,75,73,72,70,366,366,500
78,78,74,72,75,377,377,500
78,74,74,75,75,376,376,500
70,72,73,75,78,368,368,500
70,76,75,74,72,367,367,500
73,72,73,72,78,368,368,500
74,70,77,78,77,376,376,500
71,72,70,77,76,366,366,500
75,73,76,77,74,375,375,500
78,70,77,73,75,373,373,500
77,78,76,75,77,383,383,500
75,76,73,73,75,372,372,500
73,78,74,78,72,375,375,500
76,71,72,78,70,367,367,500
71,72,74,75,73,365,365,500
72,76,74,74,71,367,367,500
70,76,78,74,75,373,373,500
75,74,74,77,70,370,370,500
70,78,70,70,76,364,364,500
77,75,70,78,70,370,370,500
73,76,78,74,77,378,378,500
76,75,70,78,70,369,369,500
72,70,72,74,78,366,366,500
70,70,70,71,76,357,357,500
73,76,76,78,71,374,374,500
77,74,75,74,74,374,374,500
75,70,72,70,76,363,363,500
75,78,78,75,75,381,381,500
74,74,72,77,76,373,373,500
74,70,78,70,71,363,363,500
74,71,76,75,70,366,366,500
74,75,73,78,76,376,376,500
76,78,75,75,73,377,377,500
78,75,74,70,78,375,375,500
76,77,72,76,72,373,373,500
78,77,76,72,75,378,378,500
77,78,74,73,74,376,376,500
72,74,75,77,71,369,369,500
72,75,76,76,73,372,372,500
75,70,77,74,73,369,369,500
71,72,78,70,75,366,366,500
78,71,74,78,78,379,379,500
75,77,78,78,78,386,386,500
74,76,71,70,73,364,364,500
76,77,71,74,75,373,373,500
76,74,72,75,75,372,372,500
73,71,71,74,70,359,359,500
73,70,72,78,78,371,371,500
75,71,78,73,74,371,371,500
77,77,70,73,73,370,370,500
77,71,78,73,72,371,371,500
72,75,71,70,78,366,366,500
75,75,71,76,74,371,371,500
72,70,76,74,73,365,365,500
74,78,72,72,74,370,370,500
75,70,71,74,74,364,364,500
75,71,73,76,76,371,371,500
72,70,76,78,71,367,367,500
74,71,76,73,77,371,371,500
78,77,71,77,72,375,375,500
78,70,72,74,71,365,365,500
77,74,75,73,75,374,374,500
76,72,78,71,77,374,374,500
71,77,73,71,78,370,370,500
70,76,77,78,74,375,375,500
76,72,70,71,74,363,363,500
71,77,72,74,78,372,372,500
70,78,72,71,70,361,361,500
70,78,72,78,70,368,368,500
75,70,78,76,76,375,375,500
75,70,72,72,75,364,364,500
72,75,75,75,73,370,370,500
71,73,71,73,72,360,360,500
77,74,76,72,74,373,373,500
77,76,77,71,78,379,379,500
74,75,77,70,72,368,368,500
75,70,76,77,71,369,369,500
76,72,74,74,76,372,372,500
74,75,75,71,76,371,371,500
77,71,78,70,76,372,372,500
71,73,78,76,78,376,376,500
73,74,76,78,78,379,379,500
74,74,75,72,72,367,367,500
75,78,78,76,77,384,384,500
73,70,78,78,77,376,376,500
78,76,75,71,75,375,375,500
71,72,72,74,70,359,359,500
72,71,72,70,75,360,360,500
74,73,76,76,73,372,372,500
77,76,70,70,71,364,364,500
70,73,76,73,72,364,364,500
72,75,70,71,72,360,360,500
77,71,71,73,78,370,370,500
75,74,72,77,78,376,376,500
73,73,76,73,72,367,367,500
74,74,75,77,78,378,378,500
72,74,75,70,75,366,366,500
74,78,70,72,73,367,367,500
70,72,78,76,77,373,373,500
75,75,77,70,70,367,367,500
73,70,70,77,72,362,362,500
78,70,70,72,71,361,361,500
74,76,78,72,72,372,372,500
71,76,75,75,77,374,374,500
71,76,70,70,74,361,361,500
70,77,76,70,74,367,367,500
70,77,71,74,77,369,369,500
71,75,70,76,70,362,362,500
76,72,78,77,75,378,378,500
70,76,74,71,78,369,369,500
70,73,77,70,73,363,363,500
78,74,76,71,78,377,377,500
78,73,76,77,76,380,380,500
70,74,72,74,70,360,360,500
76,77,74,75,72,374,374,500
78,78,78,73,75,382,382,500
71,75,73,75,78,372,372,500
76,74,76,71,78,375,375,500
70,73,72,78,71,364,364,500
70,75,72,78,74,369,369,500
77,71,70,74,76,368,368,500
72,76,71,71,75,365,365,500
70,76,70,74,71,361,361,500
78,74,76,78,71,377,377,500
77,72,74,72,74,369,369,500
74,77,78,78,72,379,379,500
73,72,72,75,72,364,364,500
72,76,73,76,70,367,367,500
73,70,75,72,76,366,366,500
71,77,74,75,74,371,371,500
77,78,73,76,73,377,377,500
74,78,77,78,75,382,382,500
76,78,72,74,78,378,378,500
76,73,76,77,77,379,379,500
70,70,71,76,77,364,364,500
73,76,72,76,75,372,372,500
73,71,70,70,74,358,358,500
76,78,70,70,75,369,369,500
75,72,75,72,72,366,366,500
76,75,71,74,75,371,371,500
75,73,76,70,77,371,371,500
75,78,73,77,75,378,378,500
71,73,74,70,76,364,364,500
74,72,71,72,73,362,362,500
76,78,72,78,76,380,380,500
70,73,78,72,77,370,370,500
74,75,70,74,76,369,369,500
77,78,76,78,73,382,382,500
78,75,72,73,73,371,371,500
72,76,72,70,77,367,367,500
72,71,75,75,72,365,365,500
71,73,72,74,77,367,367,500
73,70,78,72,76,369,369,500
73,77,73,75,76,374,374,500
78,72,76,76,71,373,373,500
76,75,70,72,75,368,368,500
74,77,74,73,78,376,376,500
77,72,77,72,74,372,372,500
70,72,70,73,71,356,356,500
71,77,77,72,78,375,375,500
72,75,74,74,77,372,372,500
72,74,77,77,71,371,371,500
77,74,78,75,73,377,377,500
76,75,74,70,77,372,372,500
73,75,70,74,78,370,370,500
72,78,76,70,78,374,374,500
71,70,74,74,74,363,363,500
75,70,77,73,72,367,367,500
73,77,71,78,71,370,370,500
71,78,70,71,77,367,367,500
70,74,75,75,72,366,366,500
70,76,73,77,71,367,367,500
75,72,77,73,77,374,374,500
77,75,78,74,73,377,377,500
77,70,75,76,74,372,372,500
72,71,71,76,70,360,360,500
73,77,78,74,78,380,380,500
73,74,72,72,74,365,365,500
72,73,76,75,73,369,369,500
72,78,70,72,77,369,369,500
77,71,74,73,71,366,366,500
75,74,70,74,72,365,365,500
75,72,75,70,70,362,362,500
76,75,73,77,75,376,376,500
77,77,70,71,78,373,373,500
77,70,70,75,76,368,368,500
77,70,71,72,77,367,367,500
70,71,74,71,76,362,362,500
71,78,70,71,71,361,361,500
78,78,74,78,77,385,385,500
77,71,77,76,75,376,376,500
74,75,71,73,74,367,367,500
70,71,75,77,70,363,363,500
72,78,71,73,78,372,372,500
77,76,78,73,73,377,377,500
70,70,71,70,76,357,357,500
74,74,73,71,74,366,366,500
76,78,78,77,78,387,387,500
75,70,76,72,74,367,367,500
76,77,71,77,71,372,372,500
77,72,77,77,70,373,373,500
74,72,71,71,75,363,363,500
74,74,78,70,75,371,371,500
74,77,72,72,75,370,370,500
71,76,76,70,72,365,365,500
73,72,78,75,74,372,372,500
74,75,73,75,70,367,367,500
74,76,78,72,72,372,372,500
76,71,74,73,74,368,368,500
75,76,76,73,72,372,372,500
72,77,70,76,76,371,371,500
72,76,75,78,73,374,374,500
78,76,77,77,71,379,379,500
74,78,71,74,71,368,368,500
75,70,77,78,78,378,378,500
71,73,73,73,71,361,361,500
76,75,75,71,78,375,375,500
72,71,70,78,70,361,361,500
77,76,77,73,71,374,374,500
74,74,74,77,72,371,371,500
72,72,72,73,70,359,359,500
78,71,70,72,76,367,367,500
71,71,72,70,78,362,362,500
76,70,75,71,72,364,364,500
73,70,70,70,71,354,354,500
71,77,74,75,72,369,369,500
75,71,76,73,73,368,368,500
71,72,76,72,71,362,362,500
71,76,77,77,70,371,371,500
71,72,75,71,75,364,364,500
74,72,78,76,70,370,370,500
74,72,74,75,75,370,370,500
73,76,74,71,75,369,369,500
78,74,75,77,71,375,375,500
76,72,72,77,77,374,374,500
73,73,74,72,78,370,370,500
75,70,72,77,77,371,371,500
77,74,75,70,75,371,371,500
78,72,78,74,70,372,372,500
72,75,78,70,73,368,368,500
75,73,78,77,77,380,380,500
73,72,74,73,72,364,364,500
70,75,77,75,73,370,370,500
76,74,73,72,77,372,372,500
78,74,71,78,70,371,371,500
76,73,72,78,71,370,370,500
78,73,74,72,72,369,369,500
71,77,74,72,72,366,366,500
78,77,77,77,78,387,387,500
75,71,76,71,78,371,371,500
75,77,78,77,71,378,378,500
77,76,75,74,71,373,373,500
71,70,78,75,76,370,370,500
74,75,76,71,78,374,374,500
73,75,74,71,71,364,364,500
77,76,74,71,75,373,373,500
77,70,77,77,77,378,378,500
78,73,78,72,73,374,374,500
74,73,70,70,74,361,361,500
72,78,74,71,75,370,370,500
74,75,70,70,78,367,367,500
78,76,78,73,73,378,378,500
72,78,76,70,72,368,368,500
72,73,75,77,74,371,371,500
76,73,78,78,73,378,378,500
77,73,75,78,77,380,380,500
75,77,74,73,76,375,375,500
70,70,76,75,77,368,368,500
77,73,72,74,77,373,373,500
77,75,75,72,73,372,372,500
75,75,78,72,74,374,374,500
75,75,74,78,70,372,372,500
75,71,78,73,78,375,375,500
73,74,70,71,77,365,365,500
71,75,78,70,77,371,371,500
78,75,73,78,71,375,375,500
78,75,73,78,76,380,380,500
78,71,78,71,77,375,375,500
74,77,75,74,76,376,376,500
70,70,78,70,75,363,363,500
71,78,76,72,71,368,368,500
75,76,78,72,77,378,378,500
76,73,70,72,74,365,365,500
75,78,75,74,73,375,375,500
74,70,78,75,72,369,369,500
76,73,73,72,74,368,368,500
75,75,74,71,78,373,373,500
72,75,77,76,75,375,375,500
74,77,74,73,71,369,369,500
78,76,71,77,76,378,378,500
71,75,73,70,76,365,365,500
72,74,75,77,70,368,368,500
74,75,78,76,74,377,377,500
72,73,78,77,71,371,371,500
72,76,72,75,70,365,365,500
70,72,78,76,70,366,366,500
76,75,73,76,72,372,372,500
77,72,74,70,76,369,369,500
70,75,74,73,75,367,367,500
78,77,74,76,77,382,382,500
70,78,71,75,74,368,368,500
75,73,75,77,72,372,372,500
70,74,70,71,70,355,355,500
70,71,77,77,76,371,371,500
78,78,72,75,73,376,376,500
72,70,72,76,75,365,365,500
72,72,73,72,78,367,367,500
72,74,76,70,72,364,364,500
75,78,74,72,73,372,372,500
70,75,75,74,75,369,369,500
70,71,73,72,74,360,360,500
72,70,78,77,72,369,369,500
73,76,72,72,78,371,371,500
77,75,75,75,71,373,373,500
75,72,71,71,76,365,365,500
71,72,77,78,72,370,370,500
70,78,74,77,71,370,370,500
70,75,70,74,73,362,362,500
77,76,76,73,75,377,377,500
75,77,74,74,73,373,373,500
75,74,74,73,72,368,368,500
72,70,72,70,71,355,355,500
71,75,71,74,76,367,367,500
74,72,70,77,74,367,367,500
75,70,70,74,75,364,364,500
74,73,74,70,77,368,368,500
77,77,71,75,75,375,375,500
73,74,70,74,72,363,363,500
77,73,74,73,71,368,368,500
78,75,74,75,72,374,374,500
72,78,70,78,73,371,371,500
71,78,74,75,75,373,373,500
73,78,75,70,78,374,374,500
75,73,74,74,71,367,367,500
70,71,74,76,73,364,364,500
72,77,78,73,75,375,375,500
70,76,72,70,71,359,359,500
76,75,72,76,72,371,371,500
70,73,71,76,72,362,362,500
73,73,75,74,75,370,370,500
77,71,78,71,73,370,370,500
78,77,75,70,71,371,371,500
78,72,70,73,76,369,369,500
75,71,71,76,74,367,367,500
77,75,72,76,71,371,371,500
75,75,70,76,73,369,369,500
75,75,71,75,71,367,367,500
75,75,71,75,73,369,369,500
70,71,75,75,70,361,361,500
77,77,71,73,77,375,375,500
72,70,78,73,72,365,365,500
70,77,70,77,76,370,370,500
78,74,78,72,71,373,373,500
78,73,70,77,70,368,368,500
73,71,71,71,77,363,363,500
75,76,76,72,71,370,370,500
75,74,76,71,71,367,367,500
74,75,75,74,76,374,374,500
70,78,75,73,75,371,371,500
71,74,71,74,78,368,368,500
71,75,78,78,75,377,377,500
76,78,73,77,76,380,380,500
77,73,71,77,75,373,373,500
78,76,74,71,74,373,373,500
70,75,77,77,77,376,376,500
75,78,77,75,77,382,382,500
76,78,71,77,74,376,376,500
72,75,73,75,74,369,369,500
77,77,74,78,72,378,378,500
72,70,77,70,77,366,366,500
77,75,70,71,71,364,364,500
75,73,78,75,76,377,377,500
75,72,76,75,77,375,375,500
74,77,78,77,73,379,379,500
78,70,71,78,75,372,372,500
73,74,77,77,75,376,376,500
72,72,78,72,76,370,370,500
70,77,76,78,72,373,373,500
74,75,73,76,70,368,368,500
70,73,74,77,73,367,367,500
70,71,72,76,76,365,365,500
71,70,77,78,72,368,368,500
78,74,77,72,72,373,373,500
74,76,75,73,77,375,375,500
77,73,75,78,76,379,379,500
77,72,74,76,73,372,372,500
76,76,71,74,72,369,369,500
77,78,71,71,78,375,375,500
70,72,71,70,74,357,357,500
72,71,77,77,73,370,370,500
73,74,75,74,77,373,373,500
74,74,70,70,75,363,363,500
70,73,70,78,74,365,365,500
76,71,75,70,73,365,365,500
74,70,74,74,75,367,367,500
74,77,71,71,76,369,369,500
71,72,76,73,70,362,362,500
75,78,70,73,73,369,369,500
71,70,75,75,74,365,365,500
78,75,77,70,70,370,370,500
78,74,77,70,71,370,370,500
77,71,78,75,76,377,377,500
72,75,72,70,77,366,366,500
70,78,71,71,74,364,364,500
75,75,73,75,70,368,368,500
75,78,77,75,78,383,383,500
72,71,78,73,70,364,364,500
72,78,70,72,75,367,367,500
75,71,71,78,71,366,366,500
77,72,72,76,77,374,374,500
72,77,73,75,75,372,372,500
74,77,73,75,76,375,375,500
78,70,72,77,74,371,371,500
71,70,77,70,76,364,364,500
73,76,78,75,76,378,378,500
73,73,74,70,78,368,368,500
74,77,71,72,70,364,364,500
71,77,76,74,71,369,369,500
76,72,78,76,74,376,376,500
70,73,73,73,72,361,361,500
75,70,71,72,72,360,360,500
77,75,74,72,75,373,373,500
74,70,75,75,76,370,370,500
77,76,77,74,75,379,379,500
74,75,77,75,73,374,374,500
76,71,74,76,78,375,375,500
71,74,78,73,76,372,372,500
71,76,73,71,75,366,366,500
74,73,76,71,71,365,365,500
76,75,78,76,75,380,380,500
78,77,75,72,78,380,380,500
75,70,75,76,72,368,368,500
70,76,74,76,70,366,366,500
70,74,75,70,77,366,366,500
70,74,73,71,74,362,362,500
78,72,73,73,77,373,373,500
73,75,70,74,75,367,367,500
78,73,71,72,78,372,372,500
74,70,70,71,76,361,361,500
73,75,73,73,73,367,367,500
74,76,72,71,71,364,364,500
70,77,78,77,78,380,380,500
76,72,70,74,77,369,369,500
74,78,74,76,70,372,372,500
71,75,78,76,77,377,377,500
73,70,78,76,70,367,367,500
73,75,70,74,75,367,367,500
74,73,73,75,76,371,371,500
75,77,72,75,78,377,377,500
77,74,74,71,73,369,369,500
76,73,73,77,75,374,374,500
74,71,75,76,75,371,371,500
77,74,73,77,75,376,376,500
71,73,72,77,78,371,371,500
78,74,77,76,78,383,383,500
75,72,70,75,74,366,366,500
73,70,73,71,77,364,364,500
70,73,72,76,71,362,362,500
70,78,74,76,73,371,371,500
70,78,70,75,74,367,367,500
76,78,77,74,73,378,378,500
76,70,71,77,78,372,372,500
78,73,77,76,78,382,382,500
74,70,70,70,78,362,362,500
74,72,77,71,74,368,368,500
71,78,73,74,71,367,367,500
71,70,70,73,77,361,361,500
75,71,77,72,70,365,365,500
76,70,73,72,71,362,362,500
75,70,76,75,74,370,370,500
72,72,72,70,78,364,364,500
76,77,71,70,76,370,370,500
75,70,71,71,77,364,364,500
76,74,73,78,74,375,375,500
76,74,78,72,71,371,371,500
76,77,77,71,78,379,379,500
73,70,77,77,75,372,372,500
75,71,78,74,76,374,374,500
70,76,78,75,76,375,375,500
78,71,76,77,70,372,372,500
78,70,73,72,77,370,370,500
74,72,72,76,72,366,366,500
75,78,77,71,75,376,376,500
76,73,72,76,74,371,371,500
76,78,78,78,74,384,384,500
75,73,78,77,77,380,380,500
74,74,77,75,70,370,370,500
78,77,78,78,76,387,387,500
77,76,74,77,78,382,382,500
70,78,70,75,73,366,366,500
72,78,75,76,75,376,376,500
75,74,73,70,78,370,370,500
77,71,73,78,71,370,370,500
71,71,72,78,76,368,368,500
76,78,76,78,70,378,378,500
75,72,72,76,78,373,373,500
76,73,75,78,76,378,378,500
70,75,78,75,74,372,372,500
70,74,71,70,75,360,360,500
70,77,72,72,74,365,365,500
78,71,73,75,74,371,371,500
77,78,70,75,75,375,375,500
77,70,74,76,76,373,373,500
76,78,70,78,75,377,377,500
77,74,78,72,74,375,375,500
74,73,77,76,77,377,377,500
73,76,77,73,71,370,370,500
76,77,70,77,76,376,376,500
75,76,74,71,75,371,371,500
71,76,70,71,73,361,361,500
77,78,71,76,76,378,378,500
70,76,73,77,75,371,371,500
78,77,72,74,74,375,375,500
76,70,77,70,73,366,366,500
75,71,73,73,73,365,365,500
75,74,77,77,73,376,376,500
76,76,75,77,71,375,375,500
78,73,71,70,72,364,364,500
70,76,73,74,72,365,365,500
75,72,71,70,78,366,366,500
73,74,70,71,78,366,366,500
73,72,76,78,74,373,373,500
71,70,76,72,76,365,365,500
71,77,74,74,70,366,366,500
77,77,71,76,75,376,376,500
76,70,77,73,70,366,366,500
72,72,76,70,73,363,363,500
75,77,75,75,74,376,376,500
71,71,73,77,73,365,365,500
70,75,74,72,71,362,362,500
72,77,75,74,75,373,373,500
73,76,76,74,72,371,371,500
73,78,74,78,78,381,381,500
72,70,75,78,71,366,366,500
78,72,78,77,75,380,380,500
73,70,70,77,72,362,362,500
74,73,73,77,74,371,371,500
73,72,72,74,71,362,362,500
74,70,78,75,70,367,367,500
70,75,74,76,70,365,365,500
73,72,74,70,73,362,362,500
71,74,76,74,78,373,373,500
74,78,72,72,71,367,367,500
75,75,70,75,77,372,372,500
71,75,74,74,73,367,367,500
78,78,77,73,74,380,380,500
73,75,71,78,76,373,373,500
77,76,72,74,72,371,371,500
78,72,71,75,78,374,374,500
72,78,70,70,71,361,361,500
70,71,74,70,76,361,361,500
75,73,78,77,72,375,375,500
70,75,71,78,72,366,366,500
77,74,74,73,72,370,370,500
74,73,72,77,75,371,371,500
78,72,73,72,74,369,369,500
70,77,78,74,75,374,374,500
77,77,73,78,78,383,383,500
72,74,76,74,77,373,373,500
74,75,76,73,73,371,371,500
74,70,70,70,75,359,359,500
74,74,77,75,76,376,376,500
71,70,74,77,76,368,368,500
70,74,76,72,78,370,370,500
71,70,78,75,72,366,366,500
76,78,70,70,74,368,368,500
71,71,77,71,78,368,368,500
74,74,73,75,78,374,374,500
70,73,74,77,77,371,371,500
77,71,72,72,73,365,365,500
78,71,74,78,76,377,377,500
76,75,78,74,75,378,378,500
72,78,73,76,74,373,373,500
70,74,72,70,76,362,362,500
76,77,70,76,73,372,372,500
76,71,74,73,75,369,369,500
78,70,76,73,75,372,372,500
73,75,76,75,74,373,373,500
74,72,71,77,71,365,365,500
76,72,71,78,72,369,369,500
77,76,72,74,77,376,376,500
76,71,74,71,73,365,365,500
76,77,76,77,71,377,377,500
73,71,73,77,71,365,365,500
78,75,75,77,75,380,380,500
72,73,76,78,70,369,369,500
73,73,72,73,73,364,364,500
71,78,71,72,73,365,365,500
72,77,71,71,77,368,368,500
72,70,76,74,77,369,369,500
73,75,77,78,71,374,374,500
72,77,77,75,78,379,379,500
75,76,74,74,71,370,370,500
77,70,74,78,75,374,374,500
74,78,73,70,72,367,367,500
75,70,75,75,72,367,367,500
74,73,72,70,72,361,361,500
77,72,74,78,76,377,377,500
71,75,73,75,78,372,372,500
76,74,74,76,77,377,377,500
72,77,70,77,78,374,374,500
72,74,70,73,78,367,367,500
75,77,76,75,72,375,375,500
72,70,78,77,71,368,368,500
74,75,78,75,71,373,373,500
70,75,72,72,78,367,367,500
70,75,70,70,73,358,358,500
76,70,73,74,70,363,363,500
71,71,75,73,73,363,363,500
71,78,72,74,74,369,369,500
76,71,72,70,71,360,360,500
74,72,70,76,76,368,368,500
70,71,71,76,76,364,364,500
75,78,75,77,72,377,377,500
77,76,73,78,76,380,380,500
75,70,75,77,70,367,367,500
75,78,73,72,77,375,375,500
78,76,78,72,78,382,382,500
78,78,71,73,78,378,378,500
73,75,75,74,75,372,372,500
71,71,74,77,72,365,365,500
77,74,72,70,71,364,364,500
70,74,76,77,71,368,368,500
75,71,74,76,72,368,368,500
78,73,74,77,77,379,379,500
75,74,75,73,71,368,368,500
72,77,78,73,70,370,370,500
71,74,71,73,70,359,359,500
78,78,74,76,71,377,377,500
77,73,71,70,78,369,369,500
70,76,73,78,74,371,371,500
72,73,72,70,78,365,365,500
71,75,73,74,75,368,368,500
70,72,73,78,74,367,367,500
73,71,77,78,75,374,374,500
70,77,75,77,70,369,369,500
78,73,70,76,75,372,372,500
74,74,77,75,75,375,375,500
70,77,78,72,72,369,369,500
75,78,71,77,74,375,375,500
70,75,74,78,72,369,369,500
75,76,71,72,70,364,364,500
78,75,73,71,70,367,367,500
72,71,78,75,73,369,369,500
70,76,78,74,76,374,374,500
73,73,73,77,75,371,371,500
74,75,75,76,70,370,370,500
75,78,76,73,72,374,374,500
75,71,71,73,77,367,367,500
77,78,76,77,78,386,386,500
72,74,71,76,75,368,368,500
73,73,72,73,75,366,366,500
76,71,76,73,76,372,372,500
75,75,77,78,70,375,375,500
70,71,71,70,70,352,352,500
73,72,72,71,78,366,366,500
75,73,70,72,70,360,360,500
74,78,73,72,73,370,370,500
77,78,77,78,74,384,384,500
76,77,70,73,70,366,366,500
74,73,75,76,76,374,374,500
71,73,76,77,78,375,375,500
72,71,77,76,72,368,368,500
71,77,77,77,73,375,375,500
77,77,76,74,77,381,381,500
71,76,77,72,74,370,370,500
73,72,75,72,73,365,365,500
74,76,73,72,75,370,370,500
70,73,74,76,77,370,370,500
77,73,78,72,78,378,378,500
74,74,70,75,73,366,366,500
70,76,72,72,71,361,361,500
73,77,73,75,71,369,369,500
72,76,71,71,70,360,360,500
73,74,73,71,75,366,366,500
77,72,78,73,70,370,370,500
76,74,77,74,72,373,373,500
70,76,75,77,75,373,373,500
78,78,70,77,74,377,377,500
77,72,76,71,72,368,368,500
70,78,71,76,71,366,366,500
73,72,75,77,70,367,367,500
73,74,77,75,75,374,374,500
75,74,78,73,75,375,375,500
72,72,78,72,70,364,364,500
70,74,71,73,74,362,362,500
70,75,73,75,72,365,365,500
70,76,76,74,77,373,373,500
74,74,78,76,78,380,380,500
73,70,78,74,76,371,371,500
77,77,71,73,74,372,372,500
76,77,78,75,74,380,380,500
78,73,72,70,73,366,366,500
77,75,74,71,74,371,371,500
77,77,70,73,78,375,375,500
77,74,72,72,71,366,366,500
74,77,73,76,71,371,371,500
76,71,74,72,75,368,368,500
70,78,74,71,70,363,363,500
71,74,72,70,75,362,362,500
75,76,74,72,70,367,367,500
77,71,76,72,70,366,366,500
76,77,75,73,75,376,376,500
76,74,75,77,71,373,373,500
76,74,74,74,75,373,373,500
74,73,77,78,71,373,373,500
76,76,71,75,77,375,375,500
75,76,78,76,76,381,381,500
74,76,77,72,78,377,377,500
75,76,75,71,75,372,372,500
76,72,71,77,76,372,372,500
72,75,70,71,73,361,361,500
71,70,70,77,73,361,361,500
77,78,71,77,72,375,375,500
74,77,76,71,71,369,369,500
73,78,71,76,71,369,369,500
77,70,71,78,70,366,366,500
74,71,74,77,74,370,370,500
71,78,72,72,71,364,364,500
78,78,78,74,72,380,380,500
76,73,75,72,76,372,372,500
75,70,75,71,72,363,363,500
76,77,78,72,73,376,376,500
74,70,75,71,74,364,364,500
75,73,78,78,71,375,375,500
73,77,71,74,72,367,367,500
73,73,78,72,72,368,368,500
73,71,77,78,73,372,372,500
71,78,73,78,76,376,376,500
78,77,76,73,75,379,379,500
76,71,78,71,74,370,370,500
74,75,75,75,71,370,370,500
78,71,78,78,77,382,382,500
78,73,73,75,76,375,375,500
73,72,72,72,77,366,366,500
76,78,75,74,76,379,379,500
73,72,78,75,75,373,373,500
77,76,77,74,75,379,379,500
76,78,77,72,77,380,380,500
73,74,75,76,74,372,372,500
78,74,78,71,77,378,378,500
72,71,75,77,77,372,372,500
75,76,77,72,70,370,370,500
74,75,78,72,75,374,374,500
71,73,71,75,77,367,367,500
73,70,75,73,71,362,362,500
73,72,76,77,77,375,375,500
70,75,73,71,77,366,366,500
73,75,72,72,77,369,369,500
71,73,77,70,74,365,365,500
75,76,72,72,75,370,370,500
78,78,70,73,78,377,377,500
71,75,73,72,77,368,368,500
70,72,73,73,74,362,362,500
78,75,71,73,74,371,371,500
78,73,76,71,76,374,374,500
77,70,70,71,76,364,364,500
75,78,77,75,78,383,383,500
72,75,73,77,72,369,369,500
78,70,76,71,70,365,365,500
77,71,73,77,75,373,373,500
77,71,77,73,76,374,374,500
75,78,77,72,73,375,375,500
78,73,77,75,73,376,376,500
76,76,72,77,73,374,374,500
75,77,75,71,75,373,373,500
71,77,73,76,74,371,371,500
73,76,78,72,71,370,370,500
78,77,73,75,75,378,378,500
75,76,76,72,77,376,376,500
76,75,74,72,75,372,372,500
77,70,71,73,74,365,365,500
74,78,73,78,73,376,376,500
70,70,71,75,76,362,362,500
74,77,77,75,78,381,381,500
75,75,78,74,76,378,378,500
76,78,75,72,76,377,377,500
72,78,77,76,73,376,376,500
78,73,78,73,75,377,377,500
78,77,72,76,73,376,376,500
74,74,73,75,77,373,373,500
77,74,77,70,73,371,371,500
76,77,71,71,76,371,371,500
76,77,78,70,76,377,377,500
76,72,74,76,72,370,370,500
78,72,74,78,71,373,373,500
72,73,78,78,70,371,371,500
75,76,76,71,71,369,369,500
73,72,73,71,78,367,367,500
74,72,74,77,73,370,370,500
77,71,76,78,71,373,373,500
77,70,75,74,75,371,371,500
78,70,70,77,77,372,372,500
78,70,71,71,72,362,362,500
72,71,72,71,76,362,362,500
70,78,71,77,71,367,367,500
76,77,73,74,72,372,372,500
76,76,76,77,72,377,377,500
74,75,71,75,72,367,367,500
74,70,71,73,70,358,358,500
75,73,76,76,73,373,373,500
76,76,70,72,71,365,365,500
72,76,73,73,72,366,366,500
72,72,70,76,71,361,361,500
73,72,77,72,71,365,365,500
70,72,76,74,74,366,366,500
71,74,74,73,77,369,369,500
72,74,76,71,72,365,365,500
72,72,76,71,70,361,361,500
75,78,77,76,70,376,376,500
71,70,78,77,70,366,366,500
77,78,71,71,78,375,375,500
74,72,70,71,77,364,364,500
75,78,78,70,75,376,376,500
76,75,78,72,72,373,373,500
78,74,76,70,70,368,368,500
76,70,73,70,78,367,367,500
77,72,74,72,71,366,366,500
72,73,74,70,70,359,359,500
76,73,71,70,72,362,362,500
75,70,76,78,71,370,370,500
71,75,74,73,75,368,368,500
76,70,75,75,76,372,372,500
76,70,71,74,76,367,367,500
77,74,72,78,76,377,377,500
75,70,70,77,72,364,364,500
70,78,77,74,72,371,371,500
73,78,76,78,73,378,378,500
75,77,75,72,71,370,370,500
76,78,72,70,70,366,366,500
77,70,71,74,73,365,365,500
71,76,74,72,71,364,364,500
72,78,71,77,75,373,373,500
78,75,77,70,74,374,374,500
71,71,73,75,77,367,367,500
74,76,75,74,72,371,371,500
70,70,77,75,71,363,363,500
76,78,75,77,71,377,377,500
74,78,73,70,76,371,371,500
78,75,70,76,75,374,374,500
75,78,75,75,71,374,374,500
73,73,77,75,78,376,376,500
76,70,71,73,72,362,362,500
76,74,78,70,77,375,375,500
70,72,70,78,75,365,365,500
70,77,77,76,73,373,373,500
70,73,74,76,78,371,371,500
71,74,73,77,70,365,365,500
71,75,74,72,78,370,370,500
74,72,76,77,72,371,371,500
75,77,71,75,72,370,370,500
75,78,72,78,70,373,373,500
75,78,71,78,77,379,379,500
78,74,77,73,71,373,373,500
72,75,75,77,70,369,369,500
77,74,72,72,72,367,367,500
77,77,72,77,77,380,380,500
76,76,76,73,74,375,375,500
74,74,70,75,78,371,371,500
78,71,74,77,76,376,376,500
70,74,72,71,76,363,363,500
77,71,74,75,72,369,369,500
71,70,74,76,74,365,365,500
72,75,73,76,78,374,374,500
77,75,72,77,77,378,378,500
71,77,71,77,78,374,374,500
72,71,72,73,77,365,365,500
71,72,73,78,78,372,372,500
75,76,78,74,78,381,381,500
70,73,70,71,72,356,356,500
76,72,73,72,70,363,363,500
72,77,71,71,77,368,368,500
76,77,71,72,77,373,373,500
77,74,75,74,70,370,370,500
70,76,72,77,74,369,369,500
74,74,71,71,70,360,360,500
72,71,70,75,73,361,361,500
72,76,72,75,78,373,373,500
76,75,77,78,72,378,378,500
74,75,75,77,70,371,371,500
75,77,77,78,75,382,382,500
76,74,78,75,76,379,379,500
73,77,78,75,77,380,380,500
71,71,72,72,71,357,357,500
77,72,71,75,73,368,368,500
74,74,76,77,70,371,371,500
73,74,73,78,73,371,371,500
72,77,70,73,72,364,364,500
78,72,77,75,77,379,379,500
74,72,75,73,76,370,370,500
75,74,72,70,74,365,365,500
71,76,73,78,71,369,369,500
70,72,72,78,75,367,367,500
73,78,75,70,78,374,374,500
77,72,70,70,70,359,359,500
78,74,76,78,70,376,376,500
75,71,70,72,74,362,362,500
74,71,73,74,77,369,369,500
70,72,74,77,74,367,367,500
75,78,73,78,71,375,375,500
73,77,70,77,70,367,367,500
76,73,72,77,75,373,373,500
75,72,72,77,71,367,367,500
75,73,74,76,70,368,368,500
73,78,78,73,74,376,376,500
75,70,74,70,70,359,359,500
73,77,71,70,73,364,364,500
74,71,72,77,77,371,371,500
74,75,77,73,75,374,374,500
75,72,78,75,73,373,373,500
71,72,72,71,72,358,358,500
72,70,72,72,71,357,357,500
74,71,78,70,72,365,365,500
77,78,74,77,71,377,377,500
70,74,74,71,72,361,361,500
73,75,73,76,70,367,367,500
74,71,72,72,72,361,361,500
76,70,76,71,71,364,364,500
77,73,78,73,74,375,375,500
75,76,78,71,70,370,370,500
78,77,74,75,78,382,382,500
74,72,71,74,75,366,366,500
73,77,70,78,77,375,375,500
72,78,76,75,71,372,372,500
71,72,77,72,76,368,368,500
77,77,75,72,77,378,378,500
70,70,71,78,73,362,362,500
70,71,73,77,77,368,368,500
74,72,76,75,71,368,368,500
70,74,77,75,74,370,370,500
73,76,78,71,74,372,372,500
70,75,70,72,76,363,363,500
78,72,78,71,74,373,373,500
71,74,76,76,75,372,372,500
70,75,73,73,74,365,365,500
77,76,77,72,78,380,380,500
72,74,77,71,75,369,369,500
73,70,74,70,74,361,361,500
72,70,74,73,78,367,367,500
72,71,77,78,78,376,376,500
74,70,72,73,74,363,363,500
75,73,72,70,73,363,363,500
72,76,71,73,76,368,368,500
78,77,78,73,74,380,380,500
77,78,71,72,75,373,373,500
71,71,76,72,70,360,360,500
70,74,76,70,76,366,366,500
71,77,74,74,78,374,374,500
75,72,76,75,71,369,369,500
74,76,75,76,76,377,377,500
73,76,70,78,72,369,369,500
77,73,72,73,70,365,365,500
71,76,77,73,77,374,374,500
70,73,72,78,74,367,367,500
78,71,73,71,74,367,367,500
73,77,70,74,75,369,369,500
76,71,70,76,77,370,370,500
70,71,70,76,77,364,364,500
78,72,70,75,74,369,369,500
74,77,73,72,78,374,374,500
75,74,75,75,74,373,373,500
72,71,74,73,70,360,360,500
73,74,71,74,76,368,368,500
73,78,71,76,71,369,369,500
75,74,77,73,76,375,375,500
72,75,72,73,71,363,363,500
70,70,74,71,76,361,361,500
70,78,78,71,75,372,372,500
75,72,71,71,76,365,365,500
76,76,73,74,73,372,372,500
72,76,74,71,73,366,366,500
71,72,78,78,72,371,371,500
77,76,73,72,73,371,371,500
72,73,71,75,77,368,368,500
70,70,77,76,71,364,364,500
73,75,70,76,73,367,367,500
76,72,77,78,78,381,381,500
73,78,73,70,77,371,371,500
78,77,78,77,74,384,384,500
75,75,75,75,70,370,370,500
72,71,71,74,71,359,359,500
74,75,71,77,77,374,374,500
71,71,72,78,72,364,364,500
73,70,75,72,76,366,366,500
72,74,75,70,73,364,364,500
74,72,78,74,71,369,369,500
78,73,77,76,75,379,379,500
75,77,76,70,70,368,368,500
72,72,72,74,70,360,360,500
74,74,71,70,77,366,366,500
78,77,78,73,70,376,376,500
73,74,77,74,74,372,372,500
71,70,71,73,70,355,355,500
78,73,73,70,77,371,371,500
72,76,74,72,78,372,372,500
74,78,76,74,76,378,378,500
73,71,77,75,76,372,372,500
71,75,73,78,75,372,372,500
71,76,75,76,73,371,371,500
75,76,78,77,71,377,377,500
73,72,70,73,70,358,358,500
72,72,70,77,73,364,364,500
72,73,73,74,70,362,362,500
75,75,76,77,75,378,378,500
78,78,77,78,78,389,389,500
71,78,78,76,76,379,379,500
76,75,73,73,70,367,367,500
73,78,71,73,77,372,372,500
72,73,72,76,76,369,369,500
72,77,74,72,73,368,368,500
76,77,74,73,74,374,374,500
74,75,72,73,73,367,367,500
72,78,73,73,71,367,367,500
75,72,76,74,76,373,373,500
73,77,78,76,77,381,381,500
71,76,77,77,70,371,371,500
71,78,70,78,78,375,375,500
75,77,72,76,72,372,372,500
72,78,77,74,70,371,371,500
74,78,78,74,77,381,381,500
74,71,78,71,78,372,372,500
73,70,74,74,72,363,363,500
72,74,72,77,75,370,370,500
73,71,71,76,70,361,361,500
74,76,77,73,73,373,373,500
77,73,71,71,75,367,367,500
75,73,70,71,73,362,362,500
71,75,78,73,72,369,369,500
76,74,78,74,70,372,372,500
75,70,74,72,71,362,362,500
76,70,71,73,75,365,365,500
73,76,70,77,74,370,370,500
77,74,76,73,77,377,377,500
76,74,73,75,72,370,370,500
78,77,72,71,74,372,372,500
78,77,72,72,75,374,374,500
78,70,70,74,75,367,367,500
72,71,74,75,71,363,363,500
75,76,74,76,71,372,372,500
71,77,77,71,73,369,369,500
70,77,74,73,74,368,368,500
76,78,70,75,73,372,372,500
75,76,75,73,75,374,374,500
72,77,71,73,76,369,369,500
74,78,78,77,72,379,379,500
75,76,74,78,72,375,375,500
75,73,72,77,77,374,374,500
75,70,71,77,71,364,364,500
74,71,76,73,78,372,372,500
72,70,71,70,76,359,359,500
78,72,72,72,70,364,364,500
70,73,70,75,71,359,359,500
70,78,78,74,72,372,372,500
74,78,75,75,78,380,380,500
74,78,71,76,78,377,377,500
77,76,70,74,78,375,375,500
74,74,70,71,71,360,360,500
70,76,73,78,73,370,370,500
77,70,70,75,71,363,363,500
71,72,78,70,76,367,367,500
78,77,78,78,75,386,386,500
73,77,70,74,71,365,365,500
75,71,78,74,73,371,371,500
74,76,73,71,70,364,364,500
70,71,73,73,70,357,357,500
71,78,74,71,70,364,364,500
70,77,74,78,70,369,369,500
76,75,78,70,71,370,370,500
70,75,75,70,74,364,364,500
76,70,72,70,73,361,361,500
73,78,78,75,76,380,380,500
73,77,74,71,76,371,371,500
71,71,74,76,76,368,368,500
78,76,78,71,77,380,380,500
78,74,71,75,70,368,368,500
73,73,74,71,74,365,365,500
74,76,70,75,73,368,368,500
77,74,75,77,72,375,375,500
73,70,70,73,76,362,362,500
75,78,70,78,78,379,379,500
78,70,77,71,72,368,368,500
74,78,70,78,74,374,374,500
77,78,77,72,73,377,377,500
78,73,76,70,70,367,367,500
77,70,73,75,76,371,371,500
75,73,70,76,75,369,369,500
70,73,74,75,78,370,370,500
77,78,70,71,71,367,367,500
76,78,71,75,75,375,375,500
72,72,74,74,76,368,368,500
78,78,71,71,78,376,376,500
78,75,78,75,73,379,379,500
75,71,78,71,77,372,372,500
75,71,76,74,74,370,370,500
75,74,76,78,74,377,377,500
71,72,73,78,72,366,366,500
73,73,72,72,73,363,363,500
76,72,71,71,72,362,362,500
73,72,78,72,70,365,365,500
75,75,70,74,72,366,366,500
74,78,74,77,70,373,373,500
71,70,76,77,78,372,372,500
72,71,75,72,76,366,366,500
75,75,72,75,78,375,375,500
71,71,74,72,73,361,361,500
73,70,78,71,75,367,367,500
71,74,75,75,75,370,370,500
74,75,77,70,71,367,367,500
74,71,78,70,71,364,364,500
77,77,76,73,71,374,374,500
77,73,72,77,73,372,372,500
70,74,75,70,71,360,360,500
74,73,75,75,72,369,369,500
76,75,74,74,74,373,373,500
78,78,77,71,73,377,377,500
77,72,78,73,70,370,370,500
73,71,78,77,72,371,371,500
74,78,76,73,74,375,375,500
73,76,71,77,75,372,372,500
76,73,74,71,75,369,369,500
71,71,70,71,73,356,356,500
74,72,70,78,74,368,368,500
75,74,74,70,76,369,369,500
70,71,71,78,70,360,360,500
71,77,73,75,70,366,366,500
74,77,72,71,70,364,364,500
70,76,73,75,74,368,368,500
78,76,78,73,76,381,381,500
77,76,75,77,70,375,375,500
78,72,73,76,72,371,371,500
70,72,72,73,78,365,365,500
75,75,78,76,73,377,377,500
73,71,78,71,78,371,371,500
74,74,70,72,78,368,368,500
78,73,76,75,76,378,378,500
74,76,75,70,77,372,372,500
78,75,71,78,75,377,377,500
72,76,71,73,78,370,370,500
74,71,70,72,77,364,364,500
76,73,71,72,73,365,365,500
73,72,74,71,71,361,361,500
72,76,70,71,78,367,367,500
72,76,74,77,72,371,371,500
75,74,74,74,78,375,375,500
74,72,78,77,72,373,373,500
77,72,74,78,73,374,374,500
70,76,70,75,76,367,367,500
77,72,71,72,78,370,370,500
71,77,70,78,77,373,373,500
73,72,74,71,71,361,361,500
73,78,78,73,74,376,376,500
77,73,70,77,77,374,374,500
75,76,72,73,70,366,366,500
77,71,72,70,75,365,365,500
76,74,74,76,77,377,377,500
73,70,76,77,77,373,373,500
72,73,70,75,75,365,365,500
77,75,77,75,74,378,378,500
71,72,74,76,71,364,364,500
72,73,72,76,74,367,367,500
74,77,76,70,77,374,374,500
77,72,71,74,71,365,365,500
71,71,71,74,70,357,357,500
75,78,74,75,70,372,372,500
71,76,70,78,70,365,365,500
71,75,76,72,74,368,368,500
70,76,75,74,73,368,368,500
71,75,78,75,71,370,370,500
75,76,78,70,71,370,370,500
76,74,76,78,77,381,381,500
76,73,73,77,77,376,376,500
76,71,76,71,78,372,372,500
72,77,70,73,74,366,366,500
74,77,71,78,70,370,370,500
76,72,75,78,74,375,375,500
71,72,70,75,73,361,361,500
73,77,74,78,77,379,379,500
73,72,71,72,73,361,361,500
71,74,70,74,70,359,359,500
70,71,77,77,77,372,372,500
71,74,70,78,75,368,368,500
75,71,70,78,72,366,366,500
77,74,74,72,73,370,370,500
77,76,73,74,76,376,376,500
78,72,75,71,71,367,367,500
76,70,70,70,70,356,356,500
73,73,70,72,77,365,365,500
73,75,72,72,77,369,369,500
78,74,76,75,77,380,380,500
72,77,76,73,73,371,371,500
70,72,72,75,74,363,363,500
77,71,72,72,74,366,366,500
77,77,77,70,77,378,378,500
76,72,75,73,73,369,369,500
70,76,76,77,73,372,372,500
75,75,76,78,75,379,379,500
75,72,78,75,76,376,376,500
71,77,76,76,70,370,370,500
71,70,70,78,70,359,359,500
77,71,71,71,74,364,364,500
78,77,70,74,75,374,374,500
78,72,73,70,76,369,369,500
78,71,78,78,75,380,380,500
75,71,77,76,76,375,375,500
76,73,78,72,78,377,377,500
78,73,73,78,72,374,374,500
75,71,74,75,75,370,370,500
73,78,71,78,78,378,378,500
73,70,78,76,74,371,371,500
75,70,75,72,72,364,364,500
78,72,73,73,72,368,368,500
71,73,71,78,76,369,369,500
76,70,75,76,72,369,369,500
77,78,75,78,72,380,380,500
71,77,75,75,78,376,376,500
73,73,77,70,74,367,367,500
76,78,72,75,77,378,378,500
76,70,71,73,74,364,364,500
73,70,73,71,72,359,359,500
72,70,72,70,75,359,359,500
72,78,72,71,70,363,363,500
74,75,75,75,75,374,374,500
70,73,75,78,74,370,370,500
72,70,70,70,78,360,360,500
76,73,70,77,72,368,368,500
75,73,70,76,71,365,365,500
78,75,70,73,72,368,368,500
76,73,70,71,74,364,364,500
77,78,70,78,71,374,374,500
74,77,75,73,75,374,374,500
71,75,71,71,75,363,363,500
76,78,74,75,74,377,377,500
70,75,71,73,73,362,362,500
74,78,78,74,71,375,375,500
76,71,72,72,72,363,363,500
75,78,76,70,78,377,377,500
74,77,78,70,76,375,375,500
75,77,71,70,73,366,366,500
74,76,71,71,75,367,367,500
78,76,72,73,70,369,369,500
77,74,77,72,71,371,371,500
72,78,75,72,73,370,370,500
71,72,75,73,72,363,363,500
75,70,70,77,76,368,368,500
77,73,76,72,77,375,375,500
74,74,75,75,71,369,369,500
74,72,70,77,76,369,369,500
73,74,73,75,77,372,372,500
77,70,70,72,73,362,362,500
75,72,71,73,77,368,368,500
70,70,75,72,74,361,361,500
75,70,74,76,70,365,365,500
77,78,75,70,75,375,375,500
74,70,75,73,72,364,364,500
78,74,76,75,75,378,378,500
71,78,73,76,75,373,373,500
77,70,70,72,76,365,365,500
70,77,72,70,72,361,361,500
77,77,74,77,74,379,379,500
76,70,77,78,77,378,378,500
71,74,71,74,73,363,363,500
76,71,70,73,74,364,364,500
70,76,76,76,74,372,372,500
70,70,74,76,70,360,360,500
70,73,71,74,71,359,359,500
72,73,70,77,77,369,369,500
73,75,74,71,75,368,368,500
74,74,77,75,72,372,372,500
78,70,76,77,72,373,373,500
77,78,71,76,71,373,373,500
72,76,78,76,75,377,377,500
73,76,73,70,76,368,368,500
78,71,77,70,75,371,371,500
78,71,75,76,75,375,375,500
72,73,74,77,76,372,372,500
71,72,71,78,74,366,366,500
74,77,75,70,71,367,367,500
71,74,77,75,70,367,367,500
74,76,70,78,77,375,375,500
76,75,77,72,73,373,373,500
76,77,73,78,70,374,374,500
72,72,74,71,70,359,359,500
70,76,73,72,72,363,363,500
78,76,75,76,71,376,376,500
71,74,77,71,75,368,368,500
76,76,72,74,76,374,374,500
77,71,77,71,74,370,370,500
76,72,76,75,73,372,372,500
75,74,76,77,77,379,379,500
72,74,77,77,70,370,370,500
77,72,72,70,73,364,364,500
78,76,73,76,74,377,377,500
70,74,71,71,73,359,359,500
74,75,71,71,72,363,363,500
78,76,72,74,71,371,371,500
76,77,70,70,74,367,367,500
72,71,74,76,77,370,370,500
76,75,77,71,73,372,372,500
74,74,74,73,76,371,371,500
71,76,74,76,70,367,367,500
74,75,72,77,71,369,369,500
74,71,73,73,74,365,365,500
75,72,71,78,75,371,371,500
75,72,72,74,76,369,369,500
73,71,73,75,77,369,369,500
73,76,75,74,72,370,370,500
78,77,78,77,77,387,387,500
71,77,77,75,78,378,378,500
77,78,74,76,77,382,382,500
74,72,75,70,71,362,362,500
72,77,73,78,71,371,371,500
76,70,76,71,70,363,363,500
75,77,71,74,78,375,375,500
77,75,73,72,72,369,369,500
77,77,74,70,77,375,375,500
73,72,75,74,77,371,371,500
71,77,78,72,75,373,373,500
78,71,71,76,78,374,374,500
71,70,73,78,76,368,368,500
75,71,78,70,75,369,369,500
70,74,72,75,71,362,362,500
76,78,71,76,76,377,377,500
76,71,75,75,74,371,371,500
73,71,77,72,76,369,369,500
73,75,72,72,77,369,369,500
76,75,75,78,74,378,378,500
73,72,78,76,76,375,375,500
71,72,77,78,72,370,370,500
74,76,76,75,73,374,374,500
71,74,72,72,72,361,361,500
74,75,70,77,73,369,369,500
73,70,72,76,74,365,365,500
74,76,76,77,70,373,373,500
75,70,75,74,72,366,366,500
75,73,70,71,77,366,366,500
70,71,73,77,76,367,367,500
76,77,76,77,74,380,380,500
76,74,78,72,75,375,375,500
71,70,76,73,73,363,363,500
72,74,74,74,74,368,368,500
70,70,72,70,78,360,360,500
71,78,74,74,71,368,368,500
77,77,78,78,75,385,385,500
78,74,78,70,78,378,378,500
72,73,70,73,77,365,365,500
70,73,72,75,74,364,364,500
77,72,78,77,73,377,377,500
73,76,70,78,75,372,372,500
78,75,74,71,75,373,373,500
76,73,75,75,78,377,377,500
72,70,77,72,77,368,368,500
74,77,76,70,78,375,375,500
71,71,75,76,70,363,363,500
71,72,74,70,72,359,359,500
72,74,75,76,76,373,373,500
78,73,77,74,74,376,376,500
72,70,70,71,75,358,358,500
73,73,73,76,75,370,370,500
74,73,72,75,71,365,365,500
71,70,70,72,75,358,358,500
77,72,75,76,77,377,377,500
76,73,75,73,74,371,371,500
72,70,71,72,76,361,361,500
78,71,73,72,73,367,367,500
73,74,72,76,74,369,369,500
72,72,77,74,73,368,368,500
73,78,75,71,73,370,370,500
76,78,78,71,73,376,376,500
76,75,76,78,78,383,383,500
74,78,77,73,77,379,379,500
71,77,78,74,78,378,378,500
74,70,77,74,74,369,369,500
77,75,76,73,71,372,372,500
70,74,70,77,70,361,361,500
73,78,75,74,75,375,375,500
70,72,76,70,71,359,359,500
77,72,77,72,78,376,376,500
77,73,75,78,77,380,380,500
78,74,77,76,73,378,378,500
73,75,78,71,75,372,372,500
77,72,72,75,72,368,368,500
72,77,74,77,73,373,373,500
77,75,77,76,72,377,377,500
72,71,74,76,71,364,364,500
76,72,73,72,77,370,370,500
75,77,77,77,71,377,377,500
76,77,74,71,75,373,373,500
70,72,73,78,70,363,363,500
78,73,78,72,78,379,379,500
76,77,73,71,73,370,370,500
75,71,76,74,73,369,369,500
75,71,74,73,74,367,367,500
78,77,78,76,72,381,381,500
72,77,74,70,71,364,364,500
76,71,72,78,74,371,371,500
71,70,72,75,72,360,360,500
76,70,75,71,70,362,362,500
73,70,75,72,75,365,365,500
71,71,77,75,74,368,368,500
75,78,71,77,70,371,371,500
73,75,71,70,72,361,361,500
70,75,76,78,72,371,371,500
74,71,72,74,74,365,365,500
78,75,77,78,76,384,384,500
74,76,73,76,74,373,373,500
74,71,78,74,77,374,374,500
73,70,78,72,71,364,364,500
72,77,75,74,74,372,372,500
70,76,74,71,77,368,368,500
76,73,78,75,77,379,379,500
75,77,76,72,76,376,376,500
73,70,72,74,75,364,364,500
75,72,78,74,75,374,374,500
78,75,72,74,70,369,369,500
74,78,73,77,76,378,378,500
71,78,71,73,76,369,369,500
73,71,78,75,78,375,375,500
75,77,73,74,71,370,370,500
71,77,74,74,78,374,374,500
76,71,74,78,70,369,369,500
74,78,70,71,75,368,368,500
74,76,74,72,72,368,368,500
73,75,75,76,71,370,370,500
72,76,77,70,72,367,367,500
70,75,70,76,71,362,362,500
70,77,76,74,73,370,370,500
77,76,75,76,75,379,379,500
78,73,75,78,76,380,380,500
77,77,72,72,77,375,375,500
73,73,71,77,73,367,367,500
74,73,71,74,77,369,369,500
72,71,74,74,73,364,364,500
77,77,71,76,70,371,371,500
77,72,71,77,75,372,372,500
70,74,73,76,72,365,365,500
71,74,78,71,72,366,366,500
78,76,78,76,74,382,382,500
75,77,78,72,70,372,372,500
70,77,76,72,74,369,369,500
74,78,77,72,78,379,379,500
77,74,75,73,77,376,376,500
71,72,75,71,77,366,366,500
77,71,72,71,73,364,364,500
75,70,74,71,70,360,360,500
76,75,75,72,74,372,372,500
73,72,78,70,77,370,370,500
73,73,70,74,73,363,363,500
78,71,74,74,77,374,374,500
74,77,70,70,76,367,367,500
73,70,78,74,71,366,366,500
72,72,75,70,74,363,363,500
74,74,70,74,77,369,369,500
71,76,76,72,77,372,372,500
73,78,73,71,71,366,366,500
74,75,77,73,73,372,372,500
76,77,70,76,74,373,373,500
76,72,71,73,75,367,367,500
71,76,70,75,71,363,363,500
74,74,71,72,71,362,362,500
78,77,73,78,71,377,377,500
78,75,75,74,76,378,378,500
76,73,77,77,71,374,374,500
70,76,74,72,74,366,366,500
75,70,71,73,73,362,362,500
70,71,73,72,78,364,364,500
72,74,75,76,73,370,370,500
73,71,73,77,76,370,370,500
72,78,72,73,78,373,373,500
71,71,72,72,74,360,360,500
71,78,70,78,75,372,372,500
75,77,73,73,78,376,376,500
78,78,78,75,70,379,379,500
75,71,74,76,78,374,374,500
70,73,71,75,76,365,365,500
72,76,76,78,78,380,380,500
70,77,73,77,75,372,372,500
71,73,70,76,72,362,362,500
73,74,76,78,71,372,372,500
74,72,76,78,78,378,378,500
72,78,74,71,76,371,371,500
77,70,78,75,77,377,377,500
73,72,73,71,70,359,359,500
75,73,73,75,76,372,372,500
73,74,76,75,76,374,374,500
70,70,72,77,70,359,359,500
78,74,78,76,76,382,382,500
71,71,76,70,70,358,358,500
73,70,73,71,78,365,365,500
75,72,75,74,71,367,367,500
71,76,78,74,76,375,375,500
70,77,73,70,78,368,368,500
75,71,76,72,74,368,368,500
73,77,76,72,75,373,373,500
71,75,76,75,71,368,368,500
77,71,77,74,71,370,370,500
78,71,71,73,75,368,368,500
72,74,75,70,76,367,367,500
70,72,77,71,74,364,364,500
77,75,74,75,76,377,377,500
72,77,75,71,72,367,367,500
76,71,70,73,75,365,365,500
78,72,75,78,78,381,381,500
70,77,76,77,71,371,371,500
70,72,76,76,75,369,369,500
76,74,78,77,75,380,380,500
74,71,78,78,77,378,378,500
71,75,78,71,71,366,366,500
72,75,72,72,72,363,363,500
76,71,78,77,78,380,380,500
76,75,74,73,73,371,371,500
78,73,78,74,73,376,376,500
71,75,72,74,70,362,362,500
73,76,70,76,71,366,366,500
74,74,73,70,77,368,368,500
78,73,75,73,76,375,375,500
78,73,75,74,77,377,377,500
73,71,76,78,70,368,368,500
70,72,76,76,70,364,364,500
74,70,71,78,72,365,365,500
70,77,72,70,72,361,361,500
75,77,71,75,77,375,375,500
72,78,72,72,73,367,367,500
72,75,71,77,77,372,372,500
70,76,76,78,75,375,375,500
70,70,73,71,77,361,361,500
74,70,70,71,76,361,361,500
75,74,75,76,75,375,375,500
72,70,78,74,72,366,366,500
77,72,78,72,72,371,371,500
76,71,71,76,77,371,371,500
74,77,77,72,71,371,371,500
74,77,71,74,71,367,367,500
76,78,71,72,73,370,370,500
77,75,71,77,70,370,370,500
73,73,71,73,74,364,364,500
72,72,71,77,77,369,369,500
75,74,71,77,75,372,372,500
78,75,71,76,70,370,370,500
71,76,75,70,75,367,367,500
73,70,77,77,76,373,373,500
72,76,71,71,76,366,366,500
72,72,74,75,74,367,367,500
73,78,75,77,75,378,378,500
75,74,75,76,75,375,375,500
74,76,75,76,76,377,377,500
74,70,73,70,74,361,361,500
72,72,74,70,78,366,366,500
70,71,70,75,75,361,361,500
76,76,75,71,75,373,373,500
73,73,71,76,76,369,369,500
74,73,78,73,74,372,372,500
76,77,77,72,71,373,373,500
70,70,73,71,71,355,355,500
77,76,75,78,71,377,377,500
75,76,74,70,71,366,366,500
78,71,76,78,75,378,378,500
75,78,75,71,70,369,369,500
75,74,73,76,75,373,373,500
70,76,73,73,74,366,366,500
75,75,78,76,76,380,380,500
73,72,78,76,72,371,371,500
76,72,77,70,71,366,366,500
74,78,74,77,77,380,380,500
78,78,71,75,72,374,374,500
77,74,77,72,73,373,373,500
77,70,73,70,73,363,363,500
70,73,74,72,70,359,359,500
70,74,76,78,77,375,375,500
75,76,73,74,74,372,372,500
74,76,71,72,72,365,365,500
70,71,77,77,72,367,367,500
78,76,77,73,71,375,375,500
75,78,74,72,73,372,372,500
71,72,70,75,72,360,360,500
71,71,77,78,71,368,368,500
70,73,78,72,75,368,368,500
71,76,74,74,74,369,369,500
76,71,71,71,76,365,365,500
72,72,75,77,72,368,368,500
75,74,71,73,74,367,367,500
71,70,73,72,78,364,364,500
73,78,76,78,70,375,375,500
70,75,72,71,70,358,358,500
72,77,75,74,78,376,376,500
75,77,71,70,71,364,364,500
77,71,70,70,73,361,361,500
72,71,70,76,77,366,366,500
72,73,77,70,73,365,365,500
74,75,78,75,74,376,376,500
72,76,75,73,72,368,368,500
75,74,71,77,74,371,371,500
73,74,75,73,72,367,367,500
74,71,75,73,76,369,369,500
72,74,74,76,78,374,374,500
71,71,77,72,76,367,367,500
77,74,71,77,71,370,370,500
72,76,74,76,76,374,374,500
70,78,72,72,71,363,363,500
72,76,75,71,70,364,364,500
70,72,71,78,73,364,364,500
74,75,71,75,77,372,372,500
77,71,72,74,77,371,371,500
73,72,77,72,71,365,365,500
78,71,74,76,71,370,370,500
78,75,75,71,70,369,369,500
73,76,70,73,71,363,363,500
75,74,71,70,75,365,365,500
76,78,78,70,76,378,378,500
74,72,76,71,78,371,371,500
78,78,75,72,70,373,373,500
76,75,76,77,74,378,378,500
73,73,76,75,70,367,367,500
71,74,74,76,74,369,369,500
77,75,75,73,72,372,372,500
71,70,74,77,74,366,366,500
75,72,78,78,70,373,373,500
77,71,71,78,74,371,371,500
70,71,76,76,71,364,364,500
74,78,76,71,78,377,377,500
70,71,78,73,78,370,370,500
76,70,73,77,72,368,368,500
76,71,74,74,75,370,370,500
74,72,70,77,77,370,370,500
70,72,74,74,74,364,364,500
72,77,74,77,77,377,377,500
70,74,73,74,75,366,366,500
71,73,78,70,74,366,366,500
77,72,72,76,77,374,374,500
78,74,74,72,74,372,372,500
73,77,72,74,76,372,372,500
78,70,73,75,78,374,374,500
73,73,73,75,72,366,366,500
72,76,78,72,70,368,368,500
73,74,78,77,72,374,374,500
70,73,77,75,75,370,370,500
78,78,76,72,74,378,378,500
76,70,77,74,77,374,374,500
74,77,76,74,71,372,372,500
71,76,76,73,73,369,369,500
74,78,70,76,78,376,376,500
72,74,72,77,78,373,373,500
72,78,77,71,76,374,374,500
78,72,71,71,76,368,368,500
70,75,75,72,71,363,363,500
71,77,75,75,71,369,369,500
78,74,76,73,74,375,375,500
73,77,74,70,71,365,365,500
74,74,70,78,74,370,370,500
77,75,74,74,71,371,371,500
72,78,72,75,77,374,374,500
72,76,72,76,71,367,367,500
70,72,73,73,76,364,364,500
74,74,71,70,72,361,361,500
70,77,71,70,74,362,362,500
74,76,73,72,71,366,366,500
76,78,78,78,73,383,383,500
78,76,75,72,70,371,371,500
73,74,73,72,78,370,370,500
70,72,77,74,71,364,364,500
72,75,74,74,78,373,373,500
78,71,71,71,78,369,369,500
73,76,78,77,71,375,375,500
77,74,75,71,77,374,374,500
74,72,71,70,76,363,363,500
71,71,71,76,76,365,365,500
75,71,70,75,71,362,362,500
71,74,74,76,75,370,370,500
73,78,77,70,71,369,369,500
72,75,72,77,72,368,368,500
71,78,77,74,72,372,372,500
70,77,73,76,72,368,368,500
71,77,77,72,77,374,374,500
76,73,72,73,78,372,372,500
76,74,75,70,78,373,373,500
74,77,77,74,71,373,373,500
77,76,74,70,74,371,371,500
78,78,75,71,71,373,373,500
71,75,70,78,75,369,369,500
71,78,70,73,75,367,367,500
78,70,73,75,73,369,369,500
77,77,78,73,70,375,375,500
75,74,78,77,72,376,376,500
70,76,74,76,72,368,368,500
78,71,78,77,73,377,377,500
75,78,78,76,78,385,385,500
70,71,74,78,70,363,363,500
73,72,77,72,78,372,372,500
73,73,73,77,74,370,370,500
71,70,72,77,77,367,367,500
70,73,70,73,76,362,362,500
76,78,72,70,75,371,371,500
73,71,72,77,70,363,363,500
76,70,76,73,77,372,372,500
76,74,71,77,73,371,371,500
71,76,70,78,73,368,368,500
73,75,72,75,75,370,370,500
75,70,71,70,74,360,360,500
74,77,75,73,71,370,370,500
77,73,70,77,74,371,371,500
71,74,75,74,70,364,364,500
74,70,74,78,75,371,371,500
71,76,73,72,78,370,370,500
77,78,74,72,73,374,374,500
70,75,76,74,70,365,365,500
76,70,76,78,75,375,375,500
75,70,70,77,70,362,362,500
70,71,73,72,76,362,362,500
76,72,76,73,73,370,370,500
72,70,77,76,74,369,369,500
77,73,72,73,70,365,365,500
73,72,72,78,75,370,370,500
71,71,70,75,74,361,361,500
74,70,73,75,76,368,368,500
77,75,70,72,77,371,371,500
78,70,70,73,78,369,369,500
72,73,78,71,78,372,372,500
74,78,74,77,75,378,378,500
78,73,71,73,73,368,368,500
70,71,72,78,71,362,362,500
74,72,70,76,78,370,370,500
70,72,73,76,74,365,365,500
72,76,77,78,77,380,380,500
76,71,78,72,74,371,371,500
71,74,77,71,72,365,365,500
73,71,71,77,72,364,364,500
74,70,74,77,72,367,367,500
72,71,77,74,75,369,369,500
72,72,72,72,73,361,361,500
75,77,77,72,73,374,374,500
74,77,73,75,70,369,369,500
72,72,74,73,76,367,367,500
77,70,71,73,78,369,369,500
73,70,70,70,78,361,361,500
77,70,71,73,70,361,361,500
76,77,70,74,70,367,367,500
73,74,72,77,78,374,374,500
73,73,77,75,78,376,376,500
74,70,71,77,70,362,362,500
73,70,70,76,73,362,362,500
71,74,71,78,75,369,369,500
70,70,73,78,75,366,366,500
77,77,71,75,78,378,378,500
77,76,75,72,75,375,375,500
70,71,74,76,73,364,364,500
76,74,76,71,78,375,375,500
77,70,77,74,76,374,374,500
71,73,73,73,71,361,361,500
75,77,73,74,78,377,377,500
78,76,76,73,72,375,375,500
74,78,71,76,78,377,377,500
73,70,70,75,70,358,358,500
72,74,73,72,75,366,366,500
76,76,76,71,76,375,375,500
76,73,71,72,77,369,369,500
75,76,78,74,72,375,375,500
73,74,74,72,77,370,370,500
77,72,73,77,75,374,374,500
78,77,71,74,74,374,374,500
74,78,72,73,73,370,370,500
72,74,70,74,77,367,367,500
73,74,78,76,77,378,378,500
71,78,77,78,70,374,374,500
74,78,72,77,75,376,376,500
70,76,76,72,76,370,370,500
74,77,72,71,73,367,367,500
78,71,72,73,72,366,366,500
76,70,76,78,76,376,376,500
78,71,74,77,76,376,376,500
76,76,75,72,76,375,375,500
78,74,78,75,77,382,382,500
78,75,78,77,71,379,379,500
77,73,73,73,77,373,373,500
74,78,70,77,71,370,370,500
74,70,74,78,71,367,367,500
71,77,77,71,74,370,370,500
70,74,72,75,72,363,363,500
76,71,77,71,71,366,366,500
72,75,71,77,72,367,367,500
78,71,78,74,76,377,377,500
72,70,78,74,70,364,364,500
70,70,75,74,74,363,363,500
73,75,76,74,76,374,374,500
76,73,74,74,73,370,370,500
71,76,72,77,75,371,371,500
72,77,71,76,71,367,367,500
77,77,74,74,74,376,376,500
77,78,70,75,71,371,371,500
74,77,77,71,72,371,371,500
78,76,72,71,76,373,373,500
71,75,74,72,74,366,366,500
71,75,77,73,72,368,368,500
78,75,73,74,70,370,370,500
71,71,75,71,75,363,363,500
70,73,78,71,72,364,364,500
70,75,77,71,78,371,371,500
77,71,75,73,74,370,370,500
70,75,70,73,75,363,363,500
72,71,76,77,77,373,373,500
72,72,72,77,73,366,366,500
70,70,77,73,70,360,360,500
77,75,77,78,71,378,378,500
71,73,70,76,78,368,368,500
70,71,75,78,70,364,364,500
73,73,74,74,78,372,372,500
71,77,71,72,71,362,362,500
75,78,72,74,77,376,376,500
77,76,74,76,75,378,378,500
70,73,72,76,70,361,361,500
78,78,77,70,75,378,378,500
71,72,77,71,74,365,365,500
77,78,73,72,76,376,376,500
76,74,78,75,73,376,376,500
78,74,73,74,75,374,374,500
76,70,73,71,74,364,364,500
75,72,74,71,77,369,369,500
73,72,74,72,73,364,364,500
74,71,75,74,73,367,367,500
76,70,73,71,72,362,362,500
71,72,73,73,75,364,364,500
77,78,76,73,73,377,377,500
78,77,74,71,76,376,376,500
71,74,71,76,78,370,370,500
70,76,74,74,78,372,372,500
76,75,71,70,78,370,370,500
77,70,74,76,70,367,367,500
75,70,75,72,71,363,363,500
74,73,73,71,71,362,362,500
71,77,72,71,78,369,369,500
72,74,74,74,76,370,370,500
72,76,76,77,71,372,372,500
71,75,70,78,73,367,367,500
71,76,75,70,74,366,366,500
78,75,71,71,77,372,372,500
75,70,73,73,71,362,362,500
74,77,77,75,78,381,381,500
74,76,77,74,75,376,376,500
78,70,75,70,74,367,367,500
76,70,74,78,77,375,375,500
76,77,77,72,70,372,372,500
76,78,71,74,77,376,376,500
71,72,73,73,71,360,360,500
72,78,73,78,75,376,376,500
76,70,70,70,73,359,359,500
74,70,74,71,73,362,362,500
77,78,75,72,72,374,374,500
74,71,71,71,71,358,358,500
76,78,71,73,76,374,374,500
72,73,70,73,76,364,364,500
76,78,70,73,76,373,373,500
72,72,71,70,72,357,357,500
73,74,72,76,76,371,371,500
71,77,70,78,74,370,370,500
73,73,78,71,70,365,365,500
75,73,75,70,73,366,366,500
77,78,76,74,72,377,377,500
75,76,70,75,75,371,371,500
71,76,75,70,74,366,366,500
70,72,75,72,74,363,363,500
71,70,77,78,73,369,369,500
72,74,74,75,76,371,371,500
72,76,73,75,71,367,367,500
73,76,77,73,71,370,370,500
74,78,74,78,72,376,376,500
72,72,77,74,75,370,370,500
73,75,78,72,77,375,375,500
70,75,74,76,78,373,373,500
73,75,73,77,70,368,368,500
71,77,78,71,75,372,372,500
74,77,72,74,75,372,372,500
70,70,72,75,77,364,364,500
77,71,74,78,73,373,373,500
76,71,70,74,74,365,365,500
71,77,71,72,77,368,368,500
74,75,76,73,71,369,369,500
70,77,78,75,70,370,370,500
76,78,78,75,75,382,382,500
71,75,72,73,70,361,361,500
78,71,72,75,72,368,368,500
72,74,75,78,73,372,372,500
72,76,75,76,75,374,374,500
72,73,73,78,78,374,374,500
74,77,72,78,72,373,373,500
73,70,74,71,76,364,364,500
78,78,76,72,71,375,375,500
71,76,70,74,72,363,363,500
74,76,76,74,78,378,378,500
70,72,70,70,73,355,355,500
70,73,78,78,75,374,374,500
72,71,77,70,71,361,361,500
78,76,72,76,71,373,373,500
72,72,78,74,73,369,369,500
75,75,76,77,74,377,377,500
75,73,70,78,70,366,366,500
76,78,75,74,78,381,381,500
74,77,74,74,70,369,369,500
77,75,72,70,73,367,367,500
71,71,73,73,70,358,358,500
72,71,72,78,71,364,364,500
70,78,72,78,77,375,375,500
77,70,76,78,78,379,379,500
71,74,71,70,71,357,357,500
73,73,76,75,71,368,368,500
74,77,76,72,73,372,372,500
72,70,72,76,73,363,363,500
78,73,70,71,71,363,363,500
74,73,70,72,71,360,360,500
72,72,78,78,78,378,378,500
72,73,77,71,76,369,369,500
71,70,76,77,74,368,368,500
76,72,72,74,77,371,371,500
78,70,72,70,71,361,361,500
76,70,71,74,75,366,366,500
71,78,78,72,70,369,369,500
74,71,73,70,76,364,364,500
78,78,76,77,78,387,387,500
78,71,76,75,76,376,376,500
70,78,75,77,77,377,377,500
73,78,73,70,70,364,364,500
71,70,73,71,78,363,363,500
71,78,76,70,71,366,366,500
72,73,70,70,74,359,359,500
71,71,71,70,78,361,361,500
70,75,76,78,72,371,371,500
71,77,70,74,78,370,370,500
77,76,72,77,72,374,374,500
70,73,75,77,71,366,366,500
73,71,77,73,75,369,369,500
72,71,76,70,71,360,360,500
70,74,71,76,76,367,367,500
72,77,76,70,70,365,365,500
71,73,74,74,78,370,370,500
78,74,77,75,77,381,381,500
77,71,77,74,77,376,376,500
78,70,73,73,73,367,367,500
72,76,78,72,71,369,369,500
78,75,71,76,74,374,374,500
70,74,76,70,76,366,366,500
74,74,75,75,70,368,368,500
78,78,74,71,78,379,379,500
78,72,76,71,78,375,375,500
77,72,75,74,71,369,369,500
70,73,78,75,76,372,372,500
72,70,76,75,77,370,370,500
72,78,76,78,76,380,380,500
70,74,70,77,77,368,368,500
75,77,74,71,72,369,369,500
78,73,74,78,77,380,380,500
77,77,73,72,75,374,374,500
78,78,78,70,74,378,378,500
73,77,74,73,73,370,370,500
70,72,76,72,70,360,360,500
70,76,78,78,74,376,376,500
71,77,75,75,73,371,371,500
73,73,76,75,75,372,372,500
74,75,71,71,71,362,362,500
71,77,74,73,76,371,371,500
78,70,76,78,75,377,377,500
78,71,74,73,70,366,366,500
73,75,74,72,76,370,370,500
70,70,72,78,72,362,362,500
73,78,70,75,74,370,370,500
74,70,73,73,73,363,363,500
76,76,78,78,71,379,379,500
77,72,70,77,74,370,370,500
77,78,78,72,72,377,377,500
76,77,73,75,74,375,375,500
72,70,74,72,75,363,363,500
73,70,75,76,74,368,368,500
71,77,73,72,70,363,363,500
78,74,78,74,74,378,378,500
76,75,77,75,72,375,375,500
70,74,77,72,73,366,366,500
78,70,70,71,78,367,367,500
71,76,73,72,71,363,363,500
77,71,70,74,75,367,367,500
76,73,76,74,73,372,372,500
78,72,75,71,73,369,369,500
78,72,70,73,77,370,370,500
71,76,75,75,72,369,369,500
73,77,73,73,76,372,372,500
72,71,70,77,78,368,368,500
72,71,77,73,75,368,368,500
71,73,72,76,77,369,369,500
76,76,78,73,74,377,377,500
75,77,70,75,74,371,371,500
73,75,72,71,77,368,368,500
72,71,75,71,73,362,362,500
77,76,76,74,72,375,375,500
73,76,75,75,74,373,373,500
76,74,78,70,72,370,370,500
76,70,71,75,70,362,362,500
77,72,76,71,74,370,370,500
72,75,71,75,77,370,370,500
70,70,77,71,76,364,364,500
75,71,75,78,77,376,376,500
74,77,75,74,73,373,373,500
74,74,71,76,73,368,368,500
71,76,76,76,75,374,374,500
77,76,73,73,76,375,375,500
70,78,71,71,71,361,361,500
75,73,73,77,76,374,374,500
78,73,78,72,74,375,375,500
73,73,74,72,73,365,365,500
74,76,75,73,70,368,368,500
71,72,77,75,77,372,372,500
77,73,72,70,74,366,366,500
74,75,70,74,72,365,365,500
72,70,73,76,74,365,365,500
73,73,76,77,76,375,375,500
73,75,77,78,70,373,373,500
72,73,71,71,75,362,362,500
73,76,71,71,73,364,364,500
77,78,71,70,76,372,372,500
73,76,72,70,70,361,361,500
76,76,77,70,76,375,375,500
78,77,72,73,78,378,378,500
77,74,72,73,71,367,367,500
77,70,76,76,76,375,375,500
71,73,75,78,75,372,372,500
75,75,73,77,71,371,371,500
74,71,70,71,77,363,363,500
72,74,71,76,78,371,371,500
71,73,74,70,70,358,358,500
71,75,70,78,78,372,372,500
70,71,78,78,78,375,375,500
75,73,73,77,70,368,368,500
72,70,75,77,73,367,367,500
72,71,73,76,77,369,369,500
78,72,76,70,75,371,371,500
70,76,71,77,72,366,366,500
76,74,78,73,75,376,376,500
72,78,72,75,77,374,374,500
75,78,77,72,76,378,378,500
71,71,76,73,77,368,368,500
73,76,72,70,77,368,368,500
74,74,76,71,77,372,372,500
73,71,76,74,71,365,365,500
74,75,71,77,72,369,369,500
71,72,73,75,78,369,369,500
72,76,76,70,75,369,369,500
78,78,74,71,75,376,376,500
72,76,76,76,73,373,373,500
70,71,72,73,75,361,361,500
78,75,78,71,76,378,378,500
77,71,71,73,74,366,366,500
76,73,70,75,71,365,365,500
77,70,77,76,78,378,378,500
75,72,75,76,73,371,371,500
72,70,78,77,76,373,373,500
72,73,75,78,70,368,368,500
71,76,76,77,71,371,371,500
77,70,77,78,75,377,377,500
76,72,77,70,76,371,371,500
78,72,74,71,74,369,369,500
72,72,77,73,77,371,371,500
73,74,72,77,78,374,374,500
71,76,74,72,72,365,365,500
77,76,76,73,73,375,375,500
73,71,70,78,73,365,365,500
76,76,72,73,77,374,374,500
71,72,71,74,75,363,363,500
71,77,72,74,71,365,365,500
72,77,70,72,76,367,367,500
76,74,72,72,76,370,370,500
71,70,76,78,73,368,368,500
73,75,76,70,76,370,370,500
76,76,77,75,75,379,379,500
72,72,72,76,75,367,367,500
77,74,71,78,73,373,373,500
76,77,76,74,75,378,378,500
73,70,72,74,73,362,362,500
77,74,73,70,77,371,371,500
75,77,75,70,76,373,373,500
78,72,74,72,71,367,367,500
78,73,71,76,74,372,372,500
70,74,74,78,78,374,374,500
73,74,74,74,74,369,369,500
76,71,78,72,71,368,368,500
75,70,74,71,73,363,363,500
77,75,76,72,73,373,373,500
75,70,70,73,72,360,360,500
71,73,73,71,77,365,365,500
74,77,75,71,78,375,375,500
76,75,70,72,76,369,369,500
77,74,76,71,75,373,373,500
78,75,70,74,73,370,370,500
74,70,73,70,76,363,363,500
75,73,76,75,74,373,373,500
76,72,72,77,71,368,368,500
70,76,70,72,78,366,366,500
75,70,71,77,70,363,363,500
74,70,71,76,73,364,364,500
74,78,75,74,77,378,378,500
76,76,74,74,77,377,377,500
78,76,74,77,77,382,382,500
73,78,73,77,74,375,375,500
77,76,77,76,76,382,382,500
71,70,75,77,78,371,371,500
71,73,75,78,76,373,373,500
73,74,75,71,78,371,371,500
70,77,75,75,78,375,375,500
77,70,74,70,78,369,369,500
78,76,73,70,71,368,368,500
71,72,76,74,76,369,369,500
78,72,72,74,72,368,368,500
75,77,76,70,77,375,375,500
75,70,75,71,76,367,367,500
74,73,78,71,74,370,370,500
72,70,77,71,77,367,367,500
70,77,75,72,78,372,372,500
77,77,77,77,76,384,384,500
75,77,76,75,73,376,376,500
78,76,77,78,76,385,385,500
70,75,74,77,76,372,372,500
77,73,76,76,74,376,376,500
75,71,73,72,75,366,366,500
76,78,77,75,71,377,377,500
